Mercedes is a subject.
Ski chalet is a subject.
Dawn is a subject.

Blood on the Snow
An Interactive Fiction by PN
Release 1 / Serial number 150103 / Inform 7 build 6L38 (I6/v6.33 lib 6/12N) SD

Mountain Road
They say you shouldn't drive when you're angry. That was just one of a hundred pieces of good advice I was ignoring as I drove north along the icy road to the chalet, my foot a little heavier on the gas than it needed to be.

I'd had a long, promising career in homicide ahead of me, or so I kept telling myself, and it was all down the drain now. I had planned on a senior detective's desk being in the cards for me, at least. Maybe even quitting and going into private investigations. Well, I guessed I could still do that.

Not six hours earlier, I'd turned in my badge and my gun and walked out, more or less the way I'd seen it in the movies. The captain was yelling his head off, couldn't figure out why a promising young detective like me would just up and quit. I honestly hoped he never did.

>hint
That noun did not make sense in this context.

* * *

>clues
Clues

>hint
Objective

Clues

>i
I was carrying:
  a cell phone

* * *

>x body
I could tell he didn't get out much. His skin was slightly pallid, and not just because he was dead.

Val came up the stairs, freezing the second she saw the body. Her eyes narrowed, and I could tell her mind was racing, the first time I'd seen anything but unflappable boredom on her face. Half of me was relieved to know that there was something in this world that could shock her. The other half was unnerved by it. She looked away and hitched the poker face back on pretty quick.

Val nodded at the poor stiff and said, "Meet Professor Alan Bowden, our host this weekend."

>hint
Objective

Clues

>x wineglass
I couldn't see any such thing.

>x wine
A Bordeaux from back in 2001, uncorked and almost empty. Expensive bottle to be drinking alone.

>clues
Clues

>w
I couldn't go that way.

>d
Greatroom
The greatroom was clearly where the occupants of the house were meant to spend the majority of their time. Tall dark rafters criscrossed the high ceiling, the exposed beams clearly meant to evoke a Swiss chalet.

A large set of sofas were arranged around a huge rug. A dark stain was conspicuous against the pattern of the fabric. Everything in the room faced a gray slate fireplace. A fire roared inside, fresh logs having been added not too long ago.

A small spiral staircase in the corner led up to a reading nook, which was open to the greatroom, separated by a wooden balustrade. Coming from somewhere up there I could hear "God Rest Ye Merry, Gentlemen" warbling from what sounded like an old radio.

>x sofa
I saw nothing special about the sofa.

* * *

>s shard
I only understood you as far as wanting to (go) s.

>x shard
A broken shard of glass. The ruined facets of vintage crystal reflected light like a cheap engagement ring.

>x glass
A broken shard of glass. The ruined facets of vintage crystal reflected light like a cheap engagement ring.

>take glass
Taken.

>clues
Clues

>i
I was carrying:
  a glass shard
  a cell phone

>x shard
A broken shard of glass. The ruined facets of vintage crystal reflected light like a cheap engagement ring.

>x wineglass
The curves of the wineglass were jagged edges now, a heap of shattered crystal under the sofa. It must've fallen from quite a height.

>look
Greatroom
The greatroom was clearly where the occupants of the house were meant to spend the majority of their time. Tall dark rafters criscrossed the high ceiling, the exposed beams clearly meant to evoke a Swiss chalet.

A large set of sofas were arranged around a huge rug. A dark stain was conspicuous against the pattern of the fabric. Everything in the room faced a gray slate fireplace. A fire roared inside, fresh logs having been added not too long ago.

A small spiral staircase in the corner led up to a reading nook, which was open to the greatroom, separated by a wooden balustrade. Coming from somewhere up there I could hear "Angels We Have Heard on High" warbling from what sounded like an old radio.

I could see a broken wineglass here.

>x broken wineglass
The curves of the wineglass were jagged edges now, a heap of shattered crystal under the sofa. It must've fallen from quite a height.

>clues
Clues

broken wineglassbottle of wine

* * *

>x wineglass
I couldn't see any such thing.

* * *

>w
I couldn't go that way.

>d
Greatroom
The greatroom was clearly where the occupants of the house were meant to spend the majority of their time. Tall dark rafters criscrossed the high ceiling, the exposed beams clearly meant to evoke a Swiss chalet.

A large set of sofas were arranged around a huge rug. A dark stain was conspicuous against the pattern of the fabric. Everything in the room faced a gray slate fireplace. A fire roared inside, fresh logs having been added not too long ago.

A small spiral staircase in the corner led up to a reading nook, which was open to the greatroom, separated by a wooden balustrade. Coming from somewhere up there I heard "Hark, The Herald Angels Sing" warbling from what sounded like an old radio.

>x sofa
I saw nothing special about the sofa.

* * *

>s shard
I only understood you as far as wanting to (go) s.

>x shard
A broken shard of glass. The ruined facets of vintage crystal reflected light like a cheap engagement ring.

I crouched down for a closer look and realized it had come from a shattered wineglass,  the pieces obscured by the sofa

>x glass
I couldn't see any such thing.

>take glass
I couldn't see any such thing.

>clues
Clues

>i
I was carrying:
  a cell phone

>x shard
I couldn't see any such thing.

>x wineglass
The curves of the wineglass were jagged edges now, a heap of shattered crystal under the sofa. It must've fallen from quite a height.

>look
Greatroom
The greatroom was clearly where the occupants of the house were meant to spend the majority of their time. Tall dark rafters criscrossed the high ceiling, the exposed beams clearly meant to evoke a Swiss chalet.

A large set of sofas were arranged around a huge rug. A dark stain was conspicuous against the pattern of the fabric. Everything in the room faced a gray slate fireplace. A fire roared inside, fresh logs having been added not too long ago.

A small spiral staircase in the corner led up to a reading nook, which was open to the greatroom, separated by a wooden balustrade. Coming from somewhere up there I heard "God Rest Ye Merry, Gentlemen" warbling from what sounded like an old radio.

I could see a broken wineglass here.

>x broken wineglass
The curves of the wineglass were jagged edges now, a heap of shattered crystal under the sofa. It must've fallen from quite a height.

>clues
Clues

broken wineglass
bottle of wine

I beg your pardon?

>scenes
Scene 'Entire Game' playing (for 22 mins now)
Scene 'Mountain_Driving' ended
Scene 'Car_Escape' ended
Scene 'Cliff_Climbing' ended
Scene 'Car_Embarking' ended
Scene 'Riding_Scene' ended
Scene 'Body_Discovery' playing (for 14 mins now)
(Scene monitoring now switched on. Type "scenes off" to switch it off again.)

* * *

>hint
Objective

Clues

* * *

>w
I couldn't go that way.

>d
Greatroom
The greatroom was clearly where the occupants of the house were meant to spend the majority of their time. Tall dark rafters criscrossed the high ceiling, the exposed beams clearly meant to evoke a Swiss chalet.

A large set of sofas were arranged around a huge rug. A dark stain was conspicuous against the pattern of the fabric. Everything in the room faced a gray slate fireplace. A fire roared inside, fresh logs having been added not too long ago.

A small spiral staircase in the corner led up to a reading nook, which was open to the greatroom, separated by a wooden balustrade. Coming from somewhere up there I heard "God Rest Ye Merry, Gentlemen" warbling from what sounded like an old radio.

>x sofa
I saw nothing special about the sofa.

* * *

>x wineglass
The curves of the wineglass were jagged edges now, a heap of shattered crystal under the sofa. It must've fallen from quite a height.

>look
Greatroom
The greatroom was clearly where the occupants of the house were meant to spend the majority of their time. Tall dark rafters criscrossed the high ceiling, the exposed beams clearly meant to evoke a Swiss chalet.

A large set of sofas were arranged around a huge rug. A dark stain was conspicuous against the pattern of the fabric. Everything in the room faced a gray slate fireplace. A fire roared inside, fresh logs having been added not too long ago.

A small spiral staircase in the corner led up to a reading nook, which was open to the greatroom, separated by a wooden balustrade. Coming from somewhere up there I heard "Hark, The Herald Angels Sing" warbling from what sounded like an old radio.

I could see a broken wineglass here.

>x broken wineglass
The curves of the wineglass were jagged edges now, a heap of shattered crystal under the sofa. It must've fallen from quite a height.

>clues
Clues

broken wineglass

bottle of wine

* * *

>x wine
A Bordeaux from back in 2001, uncorked and almost empty. Expensive bottle to be drinking alone.

* * *

>x wineglass
The curves of the wineglass were jagged edges now, a heap of shattered crystal under the sofa. It must've fallen from quite a height.

>look
Greatroom
The greatroom was clearly where the occupants of the house were meant to spend the majority of their time. Tall dark rafters criscrossed the high ceiling, the exposed beams clearly meant to evoke a Swiss chalet.

A large set of sofas were arranged around a huge rug. A dark stain was conspicuous against the pattern of the fabric. Everything in the room faced a gray slate fireplace. A fire roared inside, fresh logs having been added not too long ago.

A small spiral staircase in the corner led up to a reading nook, which was open to the greatroom, separated by a wooden balustrade. Coming from somewhere up there I heard "We Three Kings" warbling from what sounded like an old radio.

I could see a broken wineglass here.

>x broken wineglass
The curves of the wineglass were jagged edges now, a heap of shattered crystal under the sofa. It must've fallen from quite a height.

* * *

>scenes
Scene 'Entire Game' playing (for 22 mins now)
Scene 'Mountain_Driving' ended
Scene 'Car_Escape' ended
Scene 'Cliff_Climbing' ended
Scene 'Car_Embarking' ended
Scene 'Riding_Scene' ended
Scene 'Body_Discovery' playing (for 14 mins now)
(Scene monitoring now switched on. Type "scenes off" to switch it off again.)

>w
Foyer
I walked into the spacious foyer, trying not to walk into the large lacquered screens in front of the door. The shiny black wood was decorated with an intricate picture in gold paint, depicting a Chinese court scene. It seemed at odds with the exterior of the house, but matched the rest of the decor; the interior was a mixture of Old World furniture and Asian influences.

A layer of snow had blown in through the open doorway, and was slowly melting into a puddle on the enormous Persian rug.

Three men stood on the rug, their coats and pant cuffs damp with snow. Val made introductions all around, as if nothing was wrong. Jan Svennson was a broad-shouldered man with pale blue eyes. He was casually brushing snow off a European performance fleece sweater. Either he liked ice climbing, or he wanted people to think he did. He had the handshake of a salesman and the grin of a frat boy.

Scott Gage, on the other hand, was tall and lanky, and didn't seem at all suited to the cold. He wore a pair of Japanese selvedge jeans with the cuffs turned up to make sure everyone knew it. I'd have guessed he'd picked them up somewhere in SoHo if it weren't for the sweater he was wearing, useless against real cold, as all Californian sweaters are. 

I studied their faces carefully. If one of them knew about Alan upstairs, they weren't letting on. The three men were overdressed for vacation, as rich men often are. But somehow, they were oddly mismatched. I doubted that they came here together.

I could also see Front_Door here.

* * *

>take wine
Taken.

>x body
I could tell he didn't get out much. His skin was slightly pallid, and not just because he was dead.

Val came up the stairs, freezing the second she saw the body. Her eyes narrowed, and I could tell her mind was racing, the first time I'd seen anything but unflappable boredom on her face. Half of me was relieved to know that there was something in this world that could shock her. The other half was unnerved by it. She looked away and hitched the poker face back on pretty quick.

Val nodded at the poor stiff and said, "Meet Professor Alan Bowden, our host this weekend."

* * *

>clues
Clues

>help
Objective

Clues

>hitn
That noun did not make sense in this context.

>hint
Objective

Clues

>help
Objective

Clues

>test
>--> The following tests are available:
'test me'
'test firstconvo'
'test sunrise_lose'
'test discover'
'test body'
'test arrival'

* * *

>e
Greatroom
The greatroom was clearly where the occupants of the house were meant to spend the majority of their time. Tall dark rafters criscrossed the high ceiling, the exposed beams clearly meant to evoke a Swiss chalet.

A large set of sofas were arranged around a huge rug. A dark stain was conspicuous on the armrest, standing out on the white fabric. Everything in the room faced a gray slate fireplace. A fire roared inside, fresh logs having been added not too long ago.

A small spiral staircase in the corner led up to a reading nook, which was open to the greatroom, separated by a wooden balustrade. Coming from somewhere up there I heard "Hark, The Herald Angels Sing" warbling from what sounded like an old radio.

>w
Foyer
I walked into the spacious foyer, trying not to walk into the large lacquered screens in front of the door. The shiny black wood was decorated with an intricate picture in gold paint, depicting a Chinese court scene. It seemed at odds with the exterior of the house, but matched the rest of the decor; the interior was a mixture of Old World furniture and Asian influences. 

The front door stood open to the porch.

>e
Greatroom
The greatroom was clearly where the occupants of the house were meant to spend the majority of their time. Tall dark rafters criscrossed the high ceiling, the exposed beams clearly meant to evoke a Swiss chalet.

A large set of sofas were arranged around a huge rug. A dark stain was conspicuous on the armrest, standing out on the white fabric. Everything in the room faced a gray slate fireplace. A fire roared inside, fresh logs having been added not too long ago.

A small spiral staircase in the corner led up to a reading nook, which was open to the greatroom, separated by a wooden balustrade. Coming from somewhere up there I heard "Angels We Have Heard on High" warbling from what sounded like an old radio.

>w
Foyer
I walked into the spacious foyer, trying not to walk into the large lacquered screens in front of the door. The shiny black wood was decorated with an intricate picture in gold paint, depicting a Chinese court scene. It seemed at odds with the exterior of the house, but matched the rest of the decor; the interior was a mixture of Old World furniture and Asian influences. 

The front door stood open to the porch.

>e
Greatroom
The greatroom was clearly where the occupants of the house were meant to spend the majority of their time. Tall dark rafters criscrossed the high ceiling, the exposed beams clearly meant to evoke a Swiss chalet.

A large set of sofas were arranged around a huge rug. A dark stain was conspicuous on the armrest, standing out on the white fabric. Everything in the room faced a gray slate fireplace. A fire roared inside, fresh logs having been added not too long ago.

A small spiral staircase in the corner led up to a reading nook, which was open to the greatroom, separated by a wooden balustrade. Coming from somewhere up there I heard "O Come, All Ye Faithful" warbling from what sounded like an old radio.

>i
I was carrying:
  a cell phone

>d
I couldn't go that way.

>w
Foyer
I walked into the spacious foyer, trying not to walk into the large lacquered screens in front of the door. The shiny black wood was decorated with an intricate picture in gold paint, depicting a Chinese court scene. It seemed at odds with the exterior of the house, but matched the rest of the decor; the interior was a mixture of Old World furniture and Asian influences. 

The front door stood open to the porch.

The front door opened, and three men filed in, a lanky one in designer jeans holding the door for the other two. He closed it behind them, and they stood there looking around and putting snow on the rug, as though they expected a butler to come and announce them.

>x val
She wore a belted black overcoat with straight shoulders, which covered all of her except for the bottom of a long pencil skirt. She hadn't bothered taking her driving gloves off. I couldn't put my finger on it, but there was something stiffly formal and practised about the way she moved.

>look
Foyer
I walked into the spacious foyer, trying not to walk into the large lacquered screens in front of the door. The shiny black wood was decorated with an intricate picture in gold paint, depicting a Chinese court scene. It seemed at odds with the exterior of the house, but matched the rest of the decor; the interior was a mixture of Old World furniture and Asian influences. 

Three men stood on the rug, their coats and pant cuffs damp with snow. Val made introductions all around, as if nothing was wrong. 

I studied their faces carefully. If one of them knew about Alan upstairs, they weren't letting on. The three men were overdressed for vacation, as rich men often are. But somehow, they were oddly mismatched. I doubted that they came here together.

I could also see Nathan, Scott and Jan here.

>scenes
Scene 'Entire Game' playing (for 25 mins now)
Scene 'Mountain_Driving' ended
Scene 'Car_Escape' ended
Scene 'Cliff_Climbing' ended
Scene 'Car_Embarking' ended
Scene 'Riding_Scene' ended
Scene 'Body_Discovery' ended
Scene 'Prearrival' ended
Scene 'Guest_Arrival' playing (for 2 mins now)
(Scene monitoring now switched on. Type "scenes off" to switch it off again.)

>e
[Scene 'Guest_Arrival' ends]
[Scene 'First_Investigation' begins]

>w
(first opening the front door)

Front Porch
Steps led up from the gravel driveway to the porch. Narrow unpainted wood planks extended the length of the house, along with windows that looked into rooms at the front of the house. Through them, I saw blinds, and a glint of something metallic, like a shutter.

The front door stood open to the porch.

* * *

>w
Front Porch
Steps led up from the gravel driveway to the porch. Narrow unpainted wood planks extended the length of the house, along with windows that looked into rooms at the front of the house. Through them, I saw blinds, and a glint of something metallic, like a shutter.

The front door stood open to the porch.

>e
Foyer
I walked into the spacious foyer, trying not to walk into the large lacquered screens in front of the door. The shiny black wood was decorated with an intricate picture in gold paint, depicting a Chinese court scene. It seemed at odds with the exterior of the house, but matched the rest of the decor; the interior was a mixture of Old World furniture and Asian influences. 

The front door stood open to the porch.

>w
Front Porch
Steps led up from the gravel driveway to the porch. Narrow unpainted wood planks extended the length of the house, along with windows that looked into rooms at the front of the house. Through them, I saw blinds, and a glint of something metallic, like a shutter.

The front door stood open to the porch.

* * *

>e
Foyer
I walked into the spacious foyer, trying not to walk into the large lacquered screens in front of the door. The shiny black wood was decorated with an intricate picture in gold paint, depicting a Chinese court scene. It seemed at odds with the exterior of the house, but matched the rest of the decor; the interior was a mixture of Old World furniture and Asian influences. 

The front door stood open to the porch.

>i
I was carrying:
  a cell phone

>d
I couldn't go that way.

The front door opened, and three men filed in, a lanky one in designer jeans holding the door for the other two. He closed it behind them, and they stood there looking around and putting snow on the rug, as though they expected a butler to come and announce them.

* * *

>x val
She wore a belted black overcoat with straight shoulders, which covered all of her except for the bottom of a long pencil skirt. She hadn't bothered taking her driving gloves off. I couldn't put my finger on it, but there was something stiffly formal and practised about the way she moved.

>look
Foyer
I walked into the spacious foyer, trying not to walk into the large lacquered screens in front of the door. The shiny black wood was decorated with an intricate picture in gold paint, depicting a Chinese court scene. It seemed at odds with the exterior of the house, but matched the rest of the decor; the interior was a mixture of Old World furniture and Asian influences. 

I could also see Nathan, Scott and Jan here.

* * *

>tet
That noun did not make sense in this context.

>test
>--> The following tests are available:
'test me'
'test firstconvo'
'test sunrise_lose'
'test discover'
'test body'
'test arrival'

* * *

I beg your pardon?

>e
Front Porch
Steps led up from the gravel driveway to the porch. Narrow unpainted wood planks extended the length of the house, along with windows that looked into rooms at the front of the house. Through them, I saw blinds, and a glint of something metallic, like a shutter.

The front door stood open to the porch.

>x door
A large wooden door, painted white as a preacher's picket fence. It didn't have a window or peephole. Something seemed odd about the lock, like it had been damaged. There was splintered wood on the side of the doorframe where someone had apparently forced the door open.

>x lock
I could see obvious scratch marks at the lock that could've been left by a lockpick. Going by the state of the doorframe, the attempt hadn't been successful.

>x doorframe
A large wooden door, painted white as a preacher's picket fence. It didn't have a window or peephole. Something seemed odd about the lock, like it had been damaged. There was splintered wood on the side of the doorframe where someone had apparently forced the door open.

>test
>--> The following tests are available:
'test me'
'test firstconvo'
'test sunrise_lose'
'test discover'
'test body'
'test arrival'

>scenes
Scene 'Entire Game' playing (for 12 mins now)
Scene 'Mountain_Driving' ended
Scene 'Car_Escape' ended
Scene 'Cliff_Climbing' ended
Scene 'Car_Embarking' ended
Scene 'Riding_Scene' ended
Scene 'Body_Discovery' playing (for 5 mins now)
(Scene monitoring now switched on. Type "scenes off" to switch it off again.)

* * *

>e
Front Porch
Steps led up from the gravel driveway to the porch. Narrow unpainted wood planks extended the length of the house, along with windows that looked into rooms at the front of the house. Through them, I saw blinds, and a glint of something metallic, like a shutter.

The front door stood open to the porch.
 I could tell that something was wrong, like the door had been damaged somehow.

>x door
A large wooden door, painted white as a preacher's picket fence. It didn't have a window or peephole. Something seemed odd about the lock, like it had been damaged. There was splintered wood on the side of the doorframe where someone had apparently forced the door open.

* * *

>scenes
Scene 'Entire Game' playing (for 12 mins now)
Scene 'Mountain_Driving' ended
Scene 'Car_Escape' ended
Scene 'Cliff_Climbing' ended
Scene 'Car_Embarking' ended
Scene 'Riding_Scene' ended
Scene 'Body_Discovery' playing (for 5 mins now)
(Scene monitoring now switched on. Type "scenes off" to switch it off again.)

>look
Front Porch
Steps led up from the gravel driveway to the porch. Narrow unpainted wood planks extended the length of the house, along with windows that looked into rooms at the front of the house. Through them, I saw blinds, and a glint of something metallic, like a shutter.

The front door stood open to the porch.

* * *

>tests
That noun did not make sense in this context.

>test
>--> The following tests are available:
'test me'
'test firstconvo'
'test sunrise_lose'
'test discover'
'test body'
'test arrival'

* * *

>e
Downstairs Hallway

>w
Greatroom
The greatroom was clearly where the occupants of the house were meant to spend the majority of their time. Tall dark rafters criscrossed the high ceiling, the exposed beams clearly meant to evoke a Swiss chalet.

A large set of sofas were arranged around a huge rug. A dark stain was conspicuous on the armrest, standing out on the white fabric. Everything in the room faced a gray slate fireplace. A fire roared inside, fresh logs having been added not too long ago.

A small spiral staircase in the corner led up to a reading nook, which was open to the greatroom, separated by a wooden balustrade. Coming from somewhere up there I heard "O Come, All Ye Faithful" warbling from what sounded like an old radio.

>w
Foyer
I walked into the spacious foyer, trying not to walk into the large lacquered screens in front of the door. The shiny black wood was decorated with an intricate picture in gold paint, depicting a Chinese court scene. It seemed at odds with the exterior of the house, but matched the rest of the decor; the interior was a mixture of Old World furniture and Asian influences. 

I could see a front door here.

>e
Greatroom
The greatroom was clearly where the occupants of the house were meant to spend the majority of their time. Tall dark rafters criscrossed the high ceiling, the exposed beams clearly meant to evoke a Swiss chalet.

A large set of sofas were arranged around a huge rug. A dark stain was conspicuous on the armrest, standing out on the white fabric. Everything in the room faced a gray slate fireplace. A fire roared inside, fresh logs having been added not too long ago.

A small spiral staircase in the corner led up to a reading nook, which was open to the greatroom, separated by a wooden balustrade. Coming from somewhere up there I heard "God Rest Ye Merry, Gentlemen" warbling from what sounded like an old radio.

>w
Foyer
I walked into the spacious foyer, trying not to walk into the large lacquered screens in front of the door. The shiny black wood was decorated with an intricate picture in gold paint, depicting a Chinese court scene. It seemed at odds with the exterior of the house, but matched the rest of the decor; the interior was a mixture of Old World furniture and Asian influences. 

I could see a front door here.

>e
Greatroom
The greatroom was clearly where the occupants of the house were meant to spend the majority of their time. Tall dark rafters criscrossed the high ceiling, the exposed beams clearly meant to evoke a Swiss chalet.

A large set of sofas were arranged around a huge rug. A dark stain was conspicuous on the armrest, standing out on the white fabric. Everything in the room faced a gray slate fireplace. A fire roared inside, fresh logs having been added not too long ago.

A small spiral staircase in the corner led up to a reading nook, which was open to the greatroom, separated by a wooden balustrade. Coming from somewhere up there I heard "O Come, All Ye Faithful" warbling from what sounded like an old radio.

>w
Foyer
I walked into the spacious foyer, trying not to walk into the large lacquered screens in front of the door. The shiny black wood was decorated with an intricate picture in gold paint, depicting a Chinese court scene. It seemed at odds with the exterior of the house, but matched the rest of the decor; the interior was a mixture of Old World furniture and Asian influences. 

I could see a front door here.

The front door opened, and three men filed in, a lanky one in designer jeans holding the door for the other two.

>look
Foyer
I walked into the spacious foyer, trying not to walk into the large lacquered screens in front of the door. The shiny black wood was decorated with an intricate picture in gold paint, depicting a Chinese court scene. It seemed at odds with the exterior of the house, but matched the rest of the decor; the interior was a mixture of Old World furniture and Asian influences. 

Three men stood on the rug, their coats and pant cuffs damp with snow. Val made introductions all around, as if nothing was wrong. Jan Svennson was a broad-shouldered man with pale blue eyes. He was casually brushing snow off a European performance fleece sweater. Either he liked ice climbing, or he wanted people to think he did. He had the handshake of a salesman and the grin of a frat boy.

Scott Gage, on the other hand, was tall and lanky, and didn't seem at all suited to the cold. He wore a pair of Japanese selvedge jeans with the cuffs turned up to make sure everyone knew it. I'd have guessed he'd picked them up somewhere in SoHo if it weren't for the sweater he was wearing, useless against real cold, as all Californian sweaters are. 

I studied their faces carefully. If one of them knew about Alan upstairs, they weren't letting on. The three men were overdressed for vacation, as rich men often are. But somehow, they were oddly mismatched. I doubted that they came here together.

I could also see Nathan, Scott, Jan and a front door here.

* * *

>test
>--> The following tests are available:
'test me'
'test firstconvo'
'test sunrise_lose'
'test discover'
'test body'
'test arrival'

* * *

>close door
I closed the front door.

>look
Foyer
I walked into the spacious foyer, trying not to walk into the large lacquered screens in front of the door. The shiny black wood was decorated with an intricate picture in gold paint, depicting a Chinese court scene. It seemed at odds with the exterior of the house, but matched the rest of the decor; the interior was a mixture of Old World furniture and Asian influences.

>e
Greatroom
The greatroom was clearly where the occupants of the house were meant to spend the majority of their time. Tall dark rafters criscrossed the high ceiling, the exposed beams clearly meant to evoke a Swiss chalet.

A large set of sofas were arranged around a huge rug. A dark stain was conspicuous on the armrest, standing out on the white fabric. Everything in the room faced a gray slate fireplace. A fire roared inside, fresh logs having been added not too long ago.

A small spiral staircase in the corner led up to a reading nook, which was open to the greatroom, separated by a wooden balustrade. Coming from somewhere up there I heard "Angels We Have Heard on High" warbling from what sounded like an old radio.

>e
Downstairs Hallway

* * *

>e
I couldn't go that way.

>w
Greatroom
The greatroom was clearly where the occupants of the house were meant to spend the majority of their time. Tall dark rafters criscrossed the high ceiling, the exposed beams clearly meant to evoke a Swiss chalet.

A large set of sofas were arranged around a huge rug. A dark stain was conspicuous on the armrest, standing out on the white fabric. Everything in the room faced a gray slate fireplace. A fire roared inside, fresh logs having been added not too long ago.

A small spiral staircase in the corner led up to a reading nook, which was open to the greatroom, separated by a wooden balustrade. Coming from somewhere up there I heard "O Come, All Ye Faithful" warbling from what sounded like an old radio.

>e
Downstairs Hallway
I heard the front door open, and the sound of voices from the foyer. It closed a minute later.

* * *

>n
I couldn't go that way.

>e
Front Porch
Steps led up from the gravel driveway to the porch. Narrow unpainted wood planks extended the length of the house, along with windows that looked into rooms at the front of the house. Through them, I saw blinds, and a glint of something metallic, like a shutter.

The front door stood open to the porch.

>x door
I saw nothing special about the front door.

>scenes
Scene 'Entire Game' playing (for 11 mins now)
Scene 'Mountain_Driving' ended
Scene 'Car_Escape' ended
Scene 'Cliff_Climbing' ended
Scene 'Car_Embarking' ended
Scene 'Riding_Scene' ended
Scene 'Body_Discovery' playing (for 4 mins now)
(Scene monitoring now switched on. Type "scenes off" to switch it off again.)

* * *

>look
Mountain Road
They say you shouldn't drive when you're angry. That was just one of a hundred pieces of good advice I was ignoring as I drove north along the icy road to the chalet, my foot a little heavier on the gas than it needed to be.

I'd had a long, promising career in homicide ahead of me, or so I kept telling myself, and it was all down the drain now. I had planned on a senior detective's desk being in the cards for me, at least. Maybe even quitting and going into private investigations. Well, I guessed I could still do that.

Not six hours earlier, I'd turned in my badge and my gun and walked out, more or less the way I'd seen it in the movies. The captain was yelling his head off, couldn't figure out why a promising young detective like me would just up and quit. I honestly hoped he never did.