Mercedes is a subject.
House is a subject.
Ski chalet is a subject.
Dawn is a subject.

Attempt to begin transcript failed.

Blood on the Snow
An Interactive Fiction by PN
Release 1 / Serial number 141209 / Inform 7 build 6L38 (I6/v6.33 lib 6/12N) SD

Mountain Road
They say you shouldn't drive when you're angry. That was just one of a hundred pieces of good advice I was ignoring as I sped down the icy road to the chalet, my foot a little heavier on the gas than it needed to be.

I'd had a long, promising career in homicide ahead of me, or so I kept telling myself, and it was all down the drain now. I had planned on a senior detective's desk being in the cards for me, at least. Hell, maybe even going into private investigations. I guess I could still do that.

Not six hours earlier, I'd turned in my badge and my gun and walked out, more or less the way I'd seen it in the movies. The captain was yelling his head off, couldn't figure out why a promising young detective like me would just up and quit. I honestly hoped he never did.

>drive
Mountain pass
I had the radio on tuned to some news station-- truth be told, I already missed the chatter of the dispatch as I was driving. The traffic report had little bearing on my current locale, but the weather gave me some concern: snowstorm coming up off the Great Lakes, apparently. Spending the weekend with a small crowd I barely knew appealed very little to me. Being cooped up with them the entire time due to weather seemed like a recipe for an epidemic of cabin fever.

>drive
Hairpin Turn
If I'd finished that last thought a few seconds earlier, I might've noticed the caution sign for the sharp turn, barely visible through the snow. The car was going too fast, and the guardrail came out of nowhere.

>brake
I hit the brakes, but the car kept straight for the guardrail, slamming through, and going over.

The back end of the car lost traction and swung out wide, trying vainly to follow the front, just like one of those car commercials. Unfortunately, I was not a professional driver, nor was this a closed course, and the right side of the car went over the edge of the cliff, momentum then taking the rest of the car with it. In shock, my brain couldn't manage to tell my body to do more than grip the wheel uselessly as the car tumbled down the steep incline. I lost count of the rolls after three. The roof hit a tree, and I'm jerked upward against the seat belt. Snow from the branches fell into a pile onto the passenger window from the impact. I heard a thud, snuffing out the brief glimpse of moonlight.

Upturned Car
I wasn't sure how long I'd been out. Taking stock of my situation, I was surprised to find myself more or less unhurt, save for a dull ache in my left wrist where I'd tried to brace against the door. I took a few deep breaths, and tried to gather myself-- I was still a little mentally a little shocked and unfocused.

The car was presently lying at the bottom of a cliff on its side. Above me, I could see moonlight, dimly mottled by the snow on the passenger side windows. The windshield in front of me showed nothing but evergreen forest, extending into the darkness.

I was still strapped in, the seat belt made sure I stayed put. At least one thing in this car still knew how to do its job right.

>kick windshield
The seat belt held me firmly in place in what was now the bottom of the upturned car. I wasn't going to be able to see or do much of anything until I unbuckled myself.

* * *

>unbuckle self
I wrestled with the jammed seat belt for a moment, then managed to undo it, falling a few inches down against the driver door once the chest belt was free.

>kick windshield
Bracing my back against the sideways seat, I gave the windshield a couple of sharp kicks, dislodging it from the frame and making myself an exit. It fell out onto the snow with a muffled crunch, and the bitter winter wind started to blow into the compartment. I grabbed my bag and stepped out into the forest.

Bottom of Cliff
I stood on a  ridge densely packed with trees some ways below the highway. My overturned car sat a few feet away. The ridge extended as far as I could see to the north, going nowhere in particular. To the west I saw the steep incline the car had rolled down, and the path it'd cut through the snow and brush.

I was miles from nowhere. It had stopped snowing for the moment. The night sky was starting to lighten, I figured I had an hour before sunrise.

Fucking swell.

>up
Sharp Bend
I stood about a hundred feet from the hairpin turn where my car had gone over; I could see the tire tracks and broken guardrail to the south.

The second I turned my head to look down the lane, I saw a pair of headlights approach. A black Mercedes pulled up and came to a stop just in front of me. The passenger door opened, and I saw Val looking out at me.

"Get in," she said.

>get in
I got into the Mercedes.

Sedan
The inside of the Mercedes was yards of brushed metal and hand-stiched leather. It even still smelled new.

Val drove the car, her eyes seemed like they were looking miles beyond the road, the mountains, and the horizon.
I'd run out of things to talk about. Nothing to do now but wait for us to get there.

* * *

>get in
You must supply a noun.

>get in
You must supply a noun.

>up
Sharp Bend
I stood about a hundred feet from the hairpin turn where my car had gone over; I could see the tire tracks and broken guardrail to the south.

The second I turned my head to look down the lane, I saw a pair of headlights approach. A black Mercedes pulled up and came to a stop just in front of me. The passenger door opened, and I saw Val looking out at me.

"Get in," she said.

>get in
I got into the Mercedes.

Sedan
The inside of the Mercedes was yards of brushed metal and hand-stiched leather. It even still smelled new. Having run out of things to talk about, nothing to do now but wait to arrive.

Val drove the car, her eyes seemed like they were looking miles beyond the road, the mountains, and the horizon.
I'd run out of things to talk about. Nothing to do now but wait for us to get there.

* * *

>drive
Hairpin Turn
If I'd finished that last thought a few seconds earlier, I might've noticed the caution sign for the sharp turn, barely visible through the snow. The car was going too fast, and the guardrail came out of nowhere.

>stop
I hit the brakes, but the car kept straight for the guardrail, slamming through, and going over.

The back end of the car lost traction and swung out wide, trying vainly to follow the front, just like one of those car commercials. Unfortunately, I was not a professional driver, nor was this a closed course, and the right side of the car went over the edge of the cliff, momentum then taking the rest of the car with it. In shock, my brain couldn't manage to tell my body to do more than grip the wheel uselessly as the car tumbled down the steep incline. I lost count of the rolls after three. The roof hit a tree, and I'm jerked upward against the seat belt. Snow from the branches fell into a pile onto the passenger window from the impact. I heard a thud, snuffing out the brief glimpse of moonlight.

Upturned Car
I wasn't sure how long I'd been out. Taking stock of my situation, I was surprised to find myself more or less unhurt, save for a dull ache in my left wrist where I'd tried to brace against the door. I took a few deep breaths, and tried to gather myself-- I was still a little mentally a little shocked and unfocused.

The car was presently lying at the bottom of a cliff on its side. Above me, I could see moonlight, dimly mottled by the snow on the passenger side windows. The windshield in front of me showed nothing but evergreen forest, extending into the darkness.

I was still strapped in, the seat belt made sure I stayed put. At least one thing in this car still knew how to do its job right.

>unbuckle self
I wrestled with the jammed seat belt for a moment, then managed to undo it, falling a few inches down against the driver door once the chest belt was free.

* * *

>up
Sharp Bend
I stood about a hundred feet from the hairpin turn where my car had gone over; I could see the tire tracks and broken guardrail to the south.

The second I turned my head to look down the lane, I saw a pair of headlights approach. A black Mercedes pulled up and came to a stop just in front of me. The passenger door opened, and I saw Val looking out at me.

"Get in," she said.

>get in
I got into the Mercedes.

Sedan
The inside of the Mercedes was yards of brushed metal and hand-stiched leather. It even still smelled new.

Val drove the car, her eyes seemed like they were looking miles beyond the road, the mountains, and the horizon.

>x val
Her dark green eyes stood out from her face like gems set in a Venetian mask. She looked to be thirty, but she could have been three hundred for all I knew. Her pale skin shone in the moonlight, contrasting with her permed auburn hair, and too-red lipstick.

>ask val about chalet
Where are we going?

My house.

I could have asked about her car or asked about sunrise.

>ask about her car
"Nice ride," I said.

"You should have called," Val replied, ignoring my comment.

I could have asked about sunrise.

>ask about sunrise
"Sun goes up at 7:03 today. Always check what time sunrise is when you leave for the night," she said.

I looked out the window, trying not to feel like a kid being scolded by his mom.

* * *

>actions
Actions listing on.

>n
[going north]

Mountain_Pass
I had the radio on tuned to some news station-- truth be told, I already missed the chatter of the dispatch as I was driving. The traffic report had little bearing on my current locale, but the weather gave me some concern: snowstorm coming up off the Great Lakes, apparently. Spending the weekend with a small crowd I barely knew appealed very little to me. Being cooped up with them the entire time due to weather seemed like a recipe for an epidemic of cabin fever.

[going north - succeeded]

>n
[going north]

Hairpin_Turn
If I'd finished that last thought a few seconds earlier, I might've noticed the caution sign for the sharp turn, barely visible through the snow. The car was going too fast, and the guardrail came out of nowhere.

[going north - succeeded]

>brake
I slammed my foot on the brakes, but to no avail.

[looking]
Bottom of Cliff
Taking stock of my situation, I was surprised to find myself more or less unhurt, save for a dull ache in my left wrist where I'd tried to brace against the door. I took a few deep breaths, and tried to gather myself-- I was still a little mentally a little shocked and unfocused.

Test

[looking - succeeded]

That's not a verb I recognise.

>look
[looking]
Bottom of Cliff
Taking stock of my situation, I was surprised to find myself more or less unhurt, save for a dull ache in my left wrist where I'd tried to brace against the door. I took a few deep breaths, and tried to gather myself-- I was still a little mentally a little shocked and unfocused.

Test

[looking - succeeded]

The back end of the car lost traction and swung out wide, trying vainly to follow the front, just like one of those car commercials. Unfortunately, I was not a professional driver, nor was this a closed course, and the right side of the car went over the edge of the cliff, momentum then taking the rest of the car with it. In shock, my brain couldn't manage to tell my body to do more than grip the wheel uselessly as the car tumbled down the steep incline. I lost count of the rolls after three. The roof hit a tree, and I'm jerked upward against the seat belt. Snow from the branches fell into a pile onto the passenger window from the impact. I heard a thud, and the moonlight I'd briefly glimpsed was snuffed out by it.

* * *

>testme
That noun did not make sense in this context.

* * *

I beg your pardon?

>unbuckle seat belt
That noun did not make sense in this context.

>kick windshield
I couldn't see any such thing.

>up
I couldn't go that way.

I could have asked about her car, asked about the chalet or asked about sunrise.

>get in
You must supply a noun.

I could have asked about her car, asked about the chalet or asked about sunrise.

>x val
Her dark green eyes stood out from her face like gems set in a Venetian mask. She looked to be thirty, but she could have been three hundred for all I knew. Her pale skin shone in the moonlight, contrasting with her permed auburn hair, and too-red lipstick.

I could have asked about her car, asked about the chalet or asked about sunrise.

>ask about chalet
Where are we going?

My house.

I could have asked about her car or asked about sunrise.

>ask about chalet
Where are we going?

My house.

I could have asked about her car or asked about sunrise.

>x val
Her dark green eyes stood out from her face like gems set in a Venetian mask. She looked to be thirty, but she could have been three hundred for all I knew. Her pale skin shone in the moonlight, contrasting with her permed auburn hair, and too-red lipstick.

I could have asked about her car or asked about sunrise.

>ask about Mercedes
That doesn't seem to be a topic of conversation at the moment.

>ask about car
"Nice ride," I said.

"You should have called," Val replied, ignoring my comment.

I could have asked about sunrise.

>ask about her car
"Nice ride," I said.

"You should have called," Val replied, ignoring my comment.

I could have asked about sunrise.

>ask about the car
"Nice ride," I said.

"You should have called," Val replied, ignoring my comment.

I could have asked about sunrise.

>ask about Mercedes
That doesn't seem to be a topic of conversation at the moment.

* * *

>kick windshield
I couldn't see any such thing.

* * *

>ask about Mercedes
That doesn't seem to be a topic of conversation at the moment.

>ask val about mercedes
That doesn't seem to be a topic of conversation at the moment.

>ask val
That doesn't seem to be a topic of conversation at the moment.

>topics
I could have asked about her car, asked about the chalet or asked about sunrise.

>ask about her car
"Nice ride," I said.

"You should have called," Val replied, ignoring my comment.

I could have asked about sunrise.

>ask about house
That doesn't seem to be a topic of conversation at the moment.

* * *

>up
I couldn't go that way.

I could have asked about her car, asked about the chalet or asked about sunrise.

* * *

>unbuckle seat belt
That noun did not make sense in this context.

* * *

>test
>--> The following tests are available:
'test me'
'test firstconvo'
'test sunrise_lose'
'test body'

* * *

>look
Reading Nook
I climbed the stairs to the reading nook. Shelves and shelves of books lined the walls of the small room, most of them either non-fiction, or bound in handsome leather. A couple of wingback armchairs faced each other with a coffee table in between.

A man sat in one, slightly paunchy and slightly grey, his eyes and mouth wide open. He was wearing a wool cardigan, damp with a dark, almost black liquid. What looked like a large carving knife was sticking out of his chest.

An antique wooden radio sits on the table, playing Christmas carols.

>look
Reading Nook
I climbed the stairs to the reading nook. Shelves and shelves of books lined the walls of the small room, most of them either non-fiction, or bound in handsome leather. A couple of wingback armchairs faced each other with a coffee table in between.

A man sat in one, slightly paunchy and slightly grey, his eyes and mouth wide open. He was wearing a wool cardigan, damp with a dark, almost black liquid. What looked like a large carving knife was sticking out of his chest.

An antique wooden radio sits on the table, playing Christmas carols.

>d
Greatroom
The greatroom was clearly where the occupants of the house were meant to spend the majority of their time. Tall dark rafters criscrossed the high ceiling, the exposed beams clearly meant to evoke a Swiss chalet.

A small spiral staircase in the corner led up to a reading nook, which was open to the greatroom, separated by a wooden balustrade. Coming from somewhere up there I could hear "God Rest Ye Merry, Gentlemen" warbling from what sounded like an old radio.

>w
Foyer
I walked into the spacious foyer, trying not to walk into the large wooden lacquered screens in front of the door. The shiny black wood was decorated with an intricate picture in gold paint, depicting a Chinese court scene. It seemed at odds with the exterior of the house, but matched the rest of the decor; the interior was a mixture of Old World furniture and Asian influences.

A layer of snow had blown in through the open doorway, slowly melting into a damp puddle on the large Persian rug.

>e
Greatroom
The greatroom was clearly where the occupants of the house were meant to spend the majority of their time. Tall dark rafters criscrossed the high ceiling, the exposed beams clearly meant to evoke a Swiss chalet.

A small spiral staircase in the corner led up to a reading nook, which was open to the greatroom, separated by a wooden balustrade. Coming from somewhere up there I could hear "We Three Kings" warbling from what sounded like an old radio.

>w
Foyer
I walked into the spacious foyer, trying not to walk into the large wooden lacquered screens in front of the door. The shiny black wood was decorated with an intricate picture in gold paint, depicting a Chinese court scene. It seemed at odds with the exterior of the house, but matched the rest of the decor; the interior was a mixture of Old World furniture and Asian influences.

A layer of snow had blown in through the open doorway, slowly melting into a damp puddle on the large Persian rug.

>e
Greatroom
The greatroom was clearly where the occupants of the house were meant to spend the majority of their time. Tall dark rafters criscrossed the high ceiling, the exposed beams clearly meant to evoke a Swiss chalet.

A small spiral staircase in the corner led up to a reading nook, which was open to the greatroom, separated by a wooden balustrade. Coming from somewhere up there I could hear "O Come, All Ye Faithful" warbling from what sounded like an old radio.

>w
Foyer
I walked into the spacious foyer, trying not to walk into the large wooden lacquered screens in front of the door. The shiny black wood was decorated with an intricate picture in gold paint, depicting a Chinese court scene. It seemed at odds with the exterior of the house, but matched the rest of the decor; the interior was a mixture of Old World furniture and Asian influences.

A layer of snow had blown in through the open doorway, slowly melting into a damp puddle on the large Persian rug.

>e
Greatroom
The greatroom was clearly where the occupants of the house were meant to spend the majority of their time. Tall dark rafters criscrossed the high ceiling, the exposed beams clearly meant to evoke a Swiss chalet.

A small spiral staircase in the corner led up to a reading nook, which was open to the greatroom, separated by a wooden balustrade. Coming from somewhere up there I could hear "Hark, The Herald Angels Sing" warbling from what sounded like an old radio.

>w
Foyer
I walked into the spacious foyer, trying not to walk into the large wooden lacquered screens in front of the door. The shiny black wood was decorated with an intricate picture in gold paint, depicting a Chinese court scene. It seemed at odds with the exterior of the house, but matched the rest of the decor; the interior was a mixture of Old World furniture and Asian influences.

A layer of snow had blown in through the open doorway, slowly melting into a damp puddle on the large Persian rug.

* * *

>e
Greatroom
The greatroom was clearly where the occupants of the house were meant to spend the majority of their time. Tall dark rafters criscrossed the high ceiling, the exposed beams clearly meant to evoke a Swiss chalet.

A small spiral staircase in the corner led up to a reading nook, which was open to the greatroom, separated by a wooden balustrade. Coming from somewhere up there I could hear "We Three Kings" warbling from what sounded like an old radio.

>u
Reading Nook
I climbed the stairs to the reading nook. Shelves and shelves of books lined the walls of the small room, most of them either non-fiction, or bound in handsome leather. A couple of wingback armchairs faced each other with a coffee table in between.

A man sat in one, slightly paunchy and slightly grey, his eyes and mouth wide open. He was wearing a wool cardigan, damp with a dark, almost black liquid. What looked like a large carving knife was sticking out of his chest.

An antique wooden radio sits on the table, playing Christmas carols.

>switch off radio
I switched the radio off.

>look
Reading Nook
I climbed the stairs to the reading nook. Shelves and shelves of books lined the walls of the small room, most of them either non-fiction, or bound in handsome leather. A couple of wingback armchairs faced each other with a coffee table in between.

A man sat in one, slightly paunchy and slightly grey, his eyes and mouth wide open. He was wearing a wool cardigan, damp with a dark, almost black liquid. What looked like a large carving knife was sticking out of his chest.

An antique wooden radio sits on the table.

>d
Greatroom
The greatroom was clearly where the occupants of the house were meant to spend the majority of their time. Tall dark rafters criscrossed the high ceiling, the exposed beams clearly meant to evoke a Swiss chalet.

A small spiral staircase in the corner led up to a reading nook, which was open to the greatroom, separated by a wooden balustrade.

>u
Reading Nook
I climbed the stairs to the reading nook. Shelves and shelves of books lined the walls of the small room, most of them either non-fiction, or bound in handsome leather. A couple of wingback armchairs faced each other with a coffee table in between.

A man sat in one, slightly paunchy and slightly grey, his eyes and mouth wide open. He was wearing a wool cardigan, damp with a dark, almost black liquid. What looked like a large carving knife was sticking out of his chest.

An antique wooden radio sits on the table.

* * *

>u
I couldn't go that way.

>d
Greatroom
The greatroom was clearly where the occupants of the house were meant to spend the majority of their time. Tall dark rafters criscrossed the high ceiling, the exposed beams clearly meant to evoke a Swiss chalet.

A small spiral staircase in the corner led up to a reading nook, which was open to the greatroom, separated by a wooden balustrade.Coming from somewhere up there I could hear "O Come All Ye Faithful" warbling from what sounded like an old radio.

>look
Greatroom
The greatroom was clearly where the occupants of the house were meant to spend the majority of their time. Tall dark rafters criscrossed the high ceiling, the exposed beams clearly meant to evoke a Swiss chalet.

A small spiral staircase in the corner led up to a reading nook, which was open to the greatroom, separated by a wooden balustrade.Coming from somewhere up there I could hear "O Come All Ye Faithful" warbling from what sounded like an old radio.

>look
Greatroom
The greatroom was clearly where the occupants of the house were meant to spend the majority of their time. Tall dark rafters criscrossed the high ceiling, the exposed beams clearly meant to evoke a Swiss chalet.

A small spiral staircase in the corner led up to a reading nook, which was open to the greatroom, separated by a wooden balustrade.Coming from somewhere up there I could hear "O Come All Ye Faithful" warbling from what sounded like an old radio.

>d
I couldn't go that way.

>w
Foyer
I walked into the spacious foyer, trying not to walk into the large wooden lacquered screens in front of the door. The shiny black wood was decorated with an intricate picture in gold paint, depicting a Chinese court scene. It seemed at odds with the exterior of the house, but matched the rest of the decor; the interior was a mixture of Old World furniture and Asian influences.

A layer of snow had blown in through the open doorway, slowly melting into a damp puddle on the large Persian rug.

>e
Greatroom
The greatroom was clearly where the occupants of the house were meant to spend the majority of their time. Tall dark rafters criscrossed the high ceiling, the exposed beams clearly meant to evoke a Swiss chalet.

A small spiral staircase in the corner led up to a reading nook, which was open to the greatroom, separated by a wooden balustrade.Coming from somewhere up there I could hear "Angels We Have Heard on High" warbling from what sounded like an old radio.

>w
Foyer
I walked into the spacious foyer, trying not to walk into the large wooden lacquered screens in front of the door. The shiny black wood was decorated with an intricate picture in gold paint, depicting a Chinese court scene. It seemed at odds with the exterior of the house, but matched the rest of the decor; the interior was a mixture of Old World furniture and Asian influences.

A layer of snow had blown in through the open doorway, slowly melting into a damp puddle on the large Persian rug.

>e
Greatroom
The greatroom was clearly where the occupants of the house were meant to spend the majority of their time. Tall dark rafters criscrossed the high ceiling, the exposed beams clearly meant to evoke a Swiss chalet.

A small spiral staircase in the corner led up to a reading nook, which was open to the greatroom, separated by a wooden balustrade.Coming from somewhere up there I could hear "O Come All Ye Faithful" warbling from what sounded like an old radio.

>w
Foyer
I walked into the spacious foyer, trying not to walk into the large wooden lacquered screens in front of the door. The shiny black wood was decorated with an intricate picture in gold paint, depicting a Chinese court scene. It seemed at odds with the exterior of the house, but matched the rest of the decor; the interior was a mixture of Old World furniture and Asian influences.

A layer of snow had blown in through the open doorway, slowly melting into a damp puddle on the large Persian rug.

* * *

>d
Greatroom
The greatroom was clearly where the occupants of the house were meant to spend the majority of their time. Tall dark rafters criscrossed the high ceiling, the exposed beams clearly meant to evoke a Swiss chalet.

A small spiral staircase in the corner led up to a reading nook, which was open to the greatroom, separated by a wooden balustrade. Coming from somewhere up there I could hear "Hark, The Herald Angels Sing" warbling from what sounded like an old radio.

>look
Greatroom
The greatroom was clearly where the occupants of the house were meant to spend the majority of their time. Tall dark rafters criscrossed the high ceiling, the exposed beams clearly meant to evoke a Swiss chalet.

A small spiral staircase in the corner led up to a reading nook, which was open to the greatroom, separated by a wooden balustrade. Coming from somewhere up there I could hear "God Rest Ye Merry, Gentlemen" warbling from what sounded like an old radio.

>look
Greatroom
The greatroom was clearly where the occupants of the house were meant to spend the majority of their time. Tall dark rafters criscrossed the high ceiling, the exposed beams clearly meant to evoke a Swiss chalet.

A small spiral staircase in the corner led up to a reading nook, which was open to the greatroom, separated by a wooden balustrade. Coming from somewhere up there I could hear "Angels We Have Heard on High" warbling from what sounded like an old radio.

>look
Greatroom
The greatroom was clearly where the occupants of the house were meant to spend the majority of their time. Tall dark rafters criscrossed the high ceiling, the exposed beams clearly meant to evoke a Swiss chalet.

A small spiral staircase in the corner led up to a reading nook, which was open to the greatroom, separated by a wooden balustrade. Coming from somewhere up there I could hear "We Three Kings" warbling from what sounded like an old radio.

>d
I couldn't go that way.

* * *

>w
Foyer
I walked into the spacious foyer, trying not to walk into the large wooden lacquered screens in front of the door. The shiny black wood was decorated with an intricate picture in gold paint, depicting a Chinese court scene. It seemed at odds with the exterior of the house, but matched the rest of the decor; the interior was a mixture of Old World furniture and Asian influences.

A layer of snow had blown in through the open doorway, slowly melting into a damp puddle on the large Persian rug.

>e
Greatroom
The greatroom was clearly where the occupants of the house were meant to spend the majority of their time. Tall dark rafters criscrossed the high ceiling, the exposed beams clearly meant to evoke a Swiss chalet.

A small spiral staircase in the corner led up to a reading nook, which was open to the greatroom, separated by a wooden balustrade. Coming from somewhere up there I could hear "God Rest Ye Merry, Gentlemen" warbling from what sounded like an old radio.

>w
Foyer
I walked into the spacious foyer, trying not to walk into the large wooden lacquered screens in front of the door. The shiny black wood was decorated with an intricate picture in gold paint, depicting a Chinese court scene. It seemed at odds with the exterior of the house, but matched the rest of the decor; the interior was a mixture of Old World furniture and Asian influences.

A layer of snow had blown in through the open doorway, slowly melting into a damp puddle on the large Persian rug.

>e
Greatroom
The greatroom was clearly where the occupants of the house were meant to spend the majority of their time. Tall dark rafters criscrossed the high ceiling, the exposed beams clearly meant to evoke a Swiss chalet.

A small spiral staircase in the corner led up to a reading nook, which was open to the greatroom, separated by a wooden balustrade. Coming from somewhere up there I could hear "Angels We Have Heard on High" warbling from what sounded like an old radio.

>u
Reading Nook
I climbed the stairs to the reading nook. Shelves and shelves of books lined the walls of the small room, most of them either non-fiction, or bound in handsome leather. A couple of wingback armchairs faced each other with a coffee table in between.

A man sat in one, slightly paunchy and slightly grey, his eyes and mouth wide open. He was wearing a wool cardigan, damp with a dark, almost black liquid. What looked like a large carving knife was sticking out of his chest.

I could see a radio here.

>switch off radio
I switched the radio off.

>look
Reading Nook
I climbed the stairs to the reading nook. Shelves and shelves of books lined the walls of the small room, most of them either non-fiction, or bound in handsome leather. A couple of wingback armchairs faced each other with a coffee table in between.

A man sat in one, slightly paunchy and slightly grey, his eyes and mouth wide open. He was wearing a wool cardigan, damp with a dark, almost black liquid. What looked like a large carving knife was sticking out of his chest.

I could see a radio here.

>d
Greatroom
The greatroom was clearly where the occupants of the house were meant to spend the majority of their time. Tall dark rafters criscrossed the high ceiling, the exposed beams clearly meant to evoke a Swiss chalet.

A small spiral staircase in the corner led up to a reading nook, which was open to the greatroom, separated by a wooden balustrade.

>u
Reading Nook
I climbed the stairs to the reading nook. Shelves and shelves of books lined the walls of the small room, most of them either non-fiction, or bound in handsome leather. A couple of wingback armchairs faced each other with a coffee table in between.

A man sat in one, slightly paunchy and slightly grey, his eyes and mouth wide open. He was wearing a wool cardigan, damp with a dark, almost black liquid. What looked like a large carving knife was sticking out of his chest.

I could see a radio here.

>switch on radio
I wasn't really in the mood for more carols.

* * *

>n
Mountain pass
I had the radio on tuned to some news station-- truth be told, I already missed the chatter of the dispatch as I was driving. The traffic report had little bearing on my current locale, but the weather gave me some concern: snowstorm coming up off the Great Lakes, apparently. Spending the weekend with a small crowd I barely knew appealed very little to me. Being cooped up with them the entire time due to weather seemed like a recipe for an epidemic of cabin fever.

>n
Hairpin Turn
If I'd finished that last thought a few seconds earlier, I might've noticed the caution sign for the sharp turn, barely visible through the snow. The car was going too fast, and the guardrail came out of nowhere.

>n
I couldn't go that way.

>n
I couldn't go that way.

>down
It's too late to stop, so I don't even bother. Instead, I press my head and back against the seat and put my arms in front of my face.

The back end of the car lost traction and swung out wide, trying vainly to follow the front, just like one of those car commercials. Unfortunately, I was not a professional driver, nor was this a closed course, and the right side of the car went over the edge of the cliff, momentum then taking the rest of the car with it. In shock, my brain couldn't manage to tell my body to do more than grip the wheel uselessly as the car tumbled down the steep incline. I lost count of the rolls after three. The roof hit a tree, and I'm jerked upward against the seat belt. Snow from the branches fell into a pile onto the passenger window from the impact. I heard a thud, snuffing out the brief glimpse of moonlight.

Upturned Sedan
Taking stock of my situation, I was surprised to find myself more or less unhurt, save for a dull ache in my left wrist where I'd tried to brace against the door. I took a few deep breaths, and tried to gather myself-- I was still a little mentally a little shocked and unfocused.

The car was presently lying at the bottom of a cliff on its side. Above me, I could see moonlight, dimly mottled by the snow on the passenger side windows. The windshield in front of me showed nothing but evergreen forest, extending into the darkness.

I was still strapped in, the seat belt made sure I stayed put. At least one thing in this car still knew how to do its job right.

>unbuckel
That's not a verb I recognise.

>unbuckle
I wrestled with the jammed seat belt for a moment, then managed to unclick it, falling a few inches down against the driver door once the chest belt was free.

>unbuckle self
That's not a verb I recognise.

>unbuckle myself
I'd already extricated myself from the restraints.

>unbuckle me
I'd already extricated myself from the restraints.

>unbuckle player
That's not a verb I recognise.

>look me
As good-looking as ever.

>x me
As good-looking as ever.

>unbuckle me
I'd already extricated myself from the restraints.

* * *

>x door
Which do you mean, the driver door or Carry out kicking the dri The passenger door?

>x
What do you want to examine?

>bite
You can't see any such thing.

>bite windshield
That's not a verb I recognise.

>look
Bottom of Cliff
Taking stock of my situation, I was surprised to find myself more or less unhurt, save for a dull ache in my left wrist where I'd tried to brace against the door. I took a few deep breaths, and tried to gather myself-- I was still a little mentally a little shocked and unfocused.Test2

* * *

>unbuckle me
I wrestled with the jammed seat belt for a moment, then managed to undo it, falling a few inches down against the driver door once the chest belt was free.

>look
Upturned Sedan
Taking stock of my situation, I was surprised to find myself more or less unhurt, save for a dull ache in my left wrist where I'd tried to brace against the door. I took a few deep breaths, and tried to gather myself-- I was still a little mentally a little shocked and unfocused.

The car was presently lying at the bottom of a cliff on its side. Above me, I could see moonlight, dimly mottled by the snow on the passenger side windows. The windshield in front of me showed nothing but evergreen forest, extending into the darkness.

I crouched at the bottom of the car on the driver door, trying to figure the best way out.

>kick door
Which do you mean, the driver door or the passenger door?

>kick driver door
It's down against a foot of packed snow, with the hard earth below that. I try to kick the driver's side door, but don't get further than cracking the window.

>attach driver door
(to the cell phone)
I would have achieved nothing by this.

>attack driver door
It's down against a foot of packed snow, with the hard earth below that. I try to kick the driver's side door, but don't get further than cracking the window.

>punch driver door
That wouldn't accomplish much.

>punch windshield
I hit the windshield a few times, and can feel it start to come loose. A good solid kick ought to do it.

>hit windshield
I hit the windshield a few times, and can feel it start to come loose. A good solid kick ought to do it.

>hit windshield
I hit the windshield a few times, and can feel it start to come loose. A good solid kick ought to do it.

>kick windshield
Bracing my back against the sideways seat, I gave the windshield a couple of sharp kicks, dislodging it from the frame and making myself an exit. It fell out onto the snow with a muffled crunch, and the bitter winter wind started to blow into the compartment. I grabbed my bag and stepped out into the forest.

Bottom of Cliff
I stood on a  ridge densely packed with trees some ways below the highway. My overturned car sat a few feet away. The ridge extended as far as I could see to the north, going nowhere in particular. To the west I saw the steep incline the car had rolled down, and the path it'd cut through the snow and brush.

I was miles from nowhere. The night sky was starting to lighten, I figured I had an hour before sunrise.

Fucking swell.

>kick passenger door
I couldn't see any such thing.

>look
Bottom of Cliff
I stood on a  ridge densely packed with trees some ways below the highway. My overturned car sat a few feet away. The ridge extended as far as I could see to the north, going nowhere in particular. To the west I saw the steep incline the car had rolled down, and the path it'd cut through the snow and brush.

I was miles from nowhere. The night sky was starting to lighten, I figured I had an hour before sunrise.

Fucking swell.

>kick windshield
I couldn't see any such thing.

>look
Bottom of Cliff
I stood on a  ridge densely packed with trees some ways below the highway. My overturned car sat a few feet away. The ridge extended as far as I could see to the north, going nowhere in particular. To the west I saw the steep incline the car had rolled down, and the path it'd cut through the snow and brush.

I was miles from nowhere. The night sky was starting to lighten, I figured I had an hour before sunrise.

Fucking swell.

>i
I was carrying:
  a cell phone

>x cell phone
I saw nothing special about the cell phone.

>look
Bottom of Cliff
I stood on a  ridge densely packed with trees some ways below the highway. My overturned car sat a few feet away. The ridge extended as far as I could see to the north, going nowhere in particular. To the west I saw the steep incline the car had rolled down, and the path it'd cut through the snow and brush.

I was miles from nowhere, and the cherry on top was that my cell phone was broken. The night sky was starting to lighten, I figured I had an hour before sunrise.

Fucking swell.

>exits
That's not a verb I recognise.

>w
Sharp Bend

>e
I couldn't go that way.

>d
Bottom of Cliff
I stood on a  ridge densely packed with trees some ways below the highway. My overturned car sat a few feet away. The ridge extended as far as I could see to the north, going nowhere in particular. To the west I saw the steep incline the car had rolled down, and the path it'd cut through the snow and brush.

I was miles from nowhere, and the cherry on top was that my cell phone was broken. The night sky was starting to lighten, I figured I had an hour before sunrise.

Fucking swell.

>n
Mountain Ridge
I tr

>look
Mountain Ridge
I tr

* * *

>look
Mountain Road
They say you shouldn't drive when you're angry. That was but one of a hundred pieces of good advice I was ignoring as I sped down the icy road to the chalet, my foot a little heavier on the gas than it needed to be.

I'd had a long, promising career in homicide ahead of me, or so I kept telling myself, and it was all down the drain now. I had planned on a senior detective's desk being in the cards for me, at least. Hell, maybe even going into private investigations. I guess I could still do that.

Not six hours earlier, I'd turned in my badge and my gun and walked out, more or less the way I'd seen it in the movies. The captain was yelling his head off, couldn't figure out why a promising young detective would just up and quit. I hoped he never did.

>look window
 Snow was coming down in great, big flakes, landing right on top of the packed, slippery mess on the road.

>look
Mountain Road
They say you shouldn't drive when you're angry. That was but one of a hundred pieces of good advice I was ignoring as I sped down the icy road to the chalet, my foot a little heavier on the gas than it needed to be.

I'd had a long, promising career in homicide ahead of me, or so I kept telling myself, and it was all down the drain now. I had planned on a senior detective's desk being in the cards for me, at least. Hell, maybe even going into private investigations. I guess I could still do that.

Not six hours earlier, I'd turned in my badge and my gun and walked out, more or less the way I'd seen it in the movies. The captain was yelling his head off, couldn't figure out why a promising young detective would just up and quit. I hoped he never did.

>drive
Mountain pass
I had the radio on tuned to some news station-- truth be told, I already missed the chatter of the dispatch as I was driving. The traffic report had little bearing on my current locale, but the weather gave me some concern: snowstorm coming up off the Great Lakes, apparently. Spending the weekend with a small crowd I barely knew appealed very little to me. Being cooped up with them the entire time due to weather seemed like a recipe for an epidemic of cabin fever.

* * *

>drive
Hairpin Turn
If I'd finished that last thought a few seconds earlier, I might've noticed the caution sign for the sharp turn, barely visible through the snow. The car was going too fast, and the guardrail came out of nowhere.

>drive
It's too late to stop, so I don't even bother. Instead, I press my head and back against the seat and put my arms in front of my face.

The back end of the car lost traction and swung out wide, trying vainly to follow the front, just like one of those car commercials. Unfortunately, I was not a professional driver, nor was this a closed course, and the right side of the car went over the edge of the cliff, momentum then taking the rest of the car with it. In shock, my brain couldn't manage to tell my body to do more than grip the wheel uselessly as the car tumbled down the steep incline. I lost count of the rolls after three. The roof hit a tree, and I'm jerked upward against the seat belt. Snow from the branches fell into a pile onto the passenger window from the impact. I heard a thud, snuffing out the brief glimpse of moonlight.

Upturned Car
I wasn't sure how long I'd been out. Taking stock of my situation, I was surprised to find myself more or less unhurt, save for a dull ache in my left wrist where I'd tried to brace against the door. I took a few deep breaths, and tried to gather myself-- I was still a little mentally a little shocked and unfocused.

The car was presently lying at the bottom of a cliff on its side. Above me, I could see moonlight, dimly mottled by the snow on the passenger side windows. The windshield in front of me showed nothing but evergreen forest, extending into the darkness.

I was still strapped in, the seat belt made sure I stayed put. At least one thing in this car still knew how to do its job right.

>unbuckle seat belt
I wrestled with the jammed seat belt for a moment, then managed to undo it, falling a few inches down against the driver door once the chest belt was free.

>open door
Which do you mean, the driver door or the passenger door?

>open driver door
It's flat on the ground, no way that's happening.

>open passenger door
There's too much snow on top. I try to push, but the weight keeps the door from opening.

>look door
Which do you mean, the driver door or the passenger door?

>look driver door
I saw nothing special about the driver door.

>kick driver door
It's down against a foot of packed snow, with the hard earth below that. I try to kick the driver's side door, but don't get further than cracking the window.

>kick windshield
Bracing my back against the sideways seat, I gave the windshield a couple of sharp kicks. I felt the seal start to give, and then it dislodged entirely from the frame, making an exit. It fell out onto the snow with a muffled crunch, and the bitter wind started to blow into the old car. I grabbed my bag and stepped out into the forest.

Bottom of Cliff
I stood on a  ridge densely packed with trees some ways below the highway. My overturned car sat a few feet away. The ridge extended as far as I could see to the north, going nowhere in particular. To the west I saw the steep incline the car had rolled down, and the path it'd cut through the snow and brush.

I was miles from nowhere. It had stopped snowing for the moment. The night sky was starting to lighten, I figured I had an hour before sunrise.

Fucking swell.

>talk to val
That noun did not make sense in this context.

>ask about car
There was no one there to talk to.

>ask about chalet
There was no one there to talk to.

>wait
Time passed.

>ask about sunrise
There was no one there to talk to.

>wait
Time passed.

>look
Bottom of Cliff
I stood on a  ridge densely packed with trees some ways below the highway. My overturned car sat a few feet away. The ridge extended as far as I could see to the north, going nowhere in particular. To the west I saw the steep incline the car had rolled down, and the path it'd cut through the snow and brush.

I was miles from nowhere. It had stopped snowing for the moment. The night sky was starting to lighten, I figured I had an hour before sunrise.

Fucking swell.

>up
Sharp Bend
I stood about a hundred feet from the hairpin turn where my car had gone over; I could see the tire tracks and broken guardrail to the south.

The second I turned my head to look down the lane, I saw a pair of headlights approach. A black Mercedes pulled up and came to a stop just in front of me. The passenger door opened, and I saw Val looking out at me.

"Get in," she said.

* * *

>get in
I got into the Mercedes.

Sedan
The inside of the Mercedes was yards of brushed metal and hand-stiched leather. It even still smelled new.

Val drove the car, her eyes seemed like they were looking miles beyond the road, the mountains, and the horizon.

>ask about car
(addressing Val)
I didn't understand that sentence.

I could have asked ask about her car, ask about the chalet or ask about sunrise.

>ask about her car
"Nice ride," I said.

"You should have called," Val replied, ignoring my comment.

I could have asked ask about the chalet or ask about sunrise.

>ask about car
"Nice ride," I said.

"You should have called," Val replied, ignoring my comment.

I could have asked ask about the chalet or ask about sunrise.

>topics
I could have asked about her car, about the chalet or about sunrise.

I could have asked about her car, about the chalet or about sunrise.

* * *

>get in
You must supply a noun.

>talk to val
That noun did not make sense in this context.