Mercedes is a subject.
Ski chalet is a subject.
Dawn is a subject.

Blood on the Snow
An Interactive Fiction by PN
Release 1 / Serial number 141226 / Inform 7 build 6L38 (I6/v6.33 lib 6/12N) SD

Mountain Road
They say you shouldn't drive when you're angry. That was just one of a hundred pieces of good advice I was ignoring as I drove north along the icy road to the chalet, my foot a little heavier on the gas than it needed to be.

I'd had a long, promising career in homicide ahead of me, or so I kept telling myself, and it was all down the drain now. I had planned on a senior detective's desk being in the cards for me, at least. Maybe even quitting and going into private investigations. Well, I guessed I could still do that.

Not six hours earlier, I'd turned in my badge and my gun and walked out, more or less the way I'd seen it in the movies. The captain was yelling his head off, couldn't figure out why a promising young detective like me would just up and quit. I honestly hoped he never did.

>test
>--> The following tests are available:
'test me'
'test firstconvo'
'test sunrise_lose'
'test discover'
'test body'
'test arrival'

>test arrival
(Testing.)

>[1] drive

Mountain Pass
I had the radio on tuned to some news station-- truth be told, I already missed the chatter of the dispatch as I was driving. The traffic report had little bearing on my current locale, but the weather gave me some concern: snowstorm coming up off the Great Lakes, apparently. Spending the weekend with a small crowd I barely knew appealed very little to me. Being cooped up with them the entire time due to weather seemed like a recipe for an epidemic of cabin fever.

>[2] drive

Hairpin Turn
If I'd finished that last thought a few seconds earlier, I might've noticed the caution sign for the sharp turn, barely visible through the snow. The car was going too fast, and the guardrail came out of nowhere.

>[3] brake
I hit the brakes, but the car kept straight for the guardrail, slamming through, and going over.

The back end of the car lost traction and swung out wide, trying vainly to follow the front, just like one of those car commercials. Unfortunately, I was not a professional driver, nor was this a closed course, and the right side of the car went over the edge of the cliff, momentum then taking the rest of the car with it. In shock, my brain couldn't manage to tell my body to do more than grip the wheel uselessly as the car tumbled down the steep incline. I lost count of the rolls after three. The roof hit a tree, and I was jerked upward against the seat belt. Snow from the branches fell into a pile onto the passenger window from the impact. I heard a thud, snuffing out the brief glimpse of moonlight.

Upturned Car
I wasn't sure how long I'd been out. Taking stock of my situation, I was surprised to find myself more or less unhurt, save for a dull ache in my left wrist where I'd tried to brace against the door. I took a few deep breaths, and tried to gather myself-- I was still a little mentally a little shocked and unfocused.

The car was presently lying at the bottom of a cliff on its side. Above me, I could see moonlight, dimly mottled by the snow on the passenger side windows. The windshield in front of me showed nothing but evergreen forest, extending into the darkness.

I was still strapped in, the seat belt made sure I stayed put. At least one thing in this car still knew how to do its job right.

>[4] unbuckle seat belt
I wrestled with the jammed seat belt for a moment, then managed to undo it, falling a few inches down against the driver door once the chest belt was free.

>[5] kick windshield
Bracing my back against the sideways seat, I gave the windshield a couple of sharp kicks. I felt the seal start to give, and then it dislodged entirely from the frame, making an exit. It fell out onto the snow with a muffled crunch, and the bitter wind started to blow into the old car. I grabbed my bag and stepped out into the forest.

I beg your pardon?

>e
Greatroom
The greatroom was clearly where the occupants of the house were meant to spend the majority of their time. Tall dark rafters criscrossed the high ceiling, the exposed beams clearly meant to evoke a Swiss chalet.

A large set of sofas were arranged around a huge rug. A dark stain was conspicuous against the pattern of the fabric. Everything in the room faced a gray slate fireplace. A fire roared inside, fresh logs having been added not too long ago.

A small spiral staircase in the corner led up to a reading nook, which was open to the greatroom, separated by a wooden balustrade. Coming from somewhere up there I could hear "God Rest Ye Merry, Gentlemen" warbling from what sounded like an old radio.

>e
Downstairs Hallway

>e
I couldn't go that way.

>e
I couldn't go that way.

>w
Greatroom
The greatroom was clearly where the occupants of the house were meant to spend the majority of their time. Tall dark rafters criscrossed the high ceiling, the exposed beams clearly meant to evoke a Swiss chalet.

A large set of sofas were arranged around a huge rug. A dark stain was conspicuous against the pattern of the fabric. Everything in the room faced a gray slate fireplace. A fire roared inside, fresh logs having been added not too long ago.

A small spiral staircase in the corner led up to a reading nook, which was open to the greatroom, separated by a wooden balustrade. Coming from somewhere up there I could hear "Angels We Have Heard on High" warbling from what sounded like an old radio.

>e
Downstairs Hallway

>w
Greatroom
The greatroom was clearly where the occupants of the house were meant to spend the majority of their time. Tall dark rafters criscrossed the high ceiling, the exposed beams clearly meant to evoke a Swiss chalet.

A large set of sofas were arranged around a huge rug. A dark stain was conspicuous against the pattern of the fabric. Everything in the room faced a gray slate fireplace. A fire roared inside, fresh logs having been added not too long ago.

A small spiral staircase in the corner led up to a reading nook, which was open to the greatroom, separated by a wooden balustrade. Coming from somewhere up there I could hear "Angels We Have Heard on High" warbling from what sounded like an old radio.

>scenes
Scene 'Entire Game' playing (for 23 mins now)
Scene 'Mountain_Driving' ended
Scene 'Car_Escape' ended
Scene 'Cliff_Climbing' ended
Scene 'Car_Embarking' ended
Scene 'Riding_Scene' ended
Scene 'Body_Discovery' ended
Scene 'Prearrival' playing (for 11 mins now)
(Scene monitoring now switched on. Type "scenes off" to switch it off again.)

>scope
1: myself (746789)
2: a stain (747813)
3: a sofa (747845)
4: a cell phone (746821)

>values
That noun did not make sense in this context.

>e
Downstairs Hallway

>n
I couldn't go that way.

>u
Upstairs Hallway

>e
(first opening PC_Bedroom_Door)

PC_Bedroom
I checked my watch, it was getting late, almost noon. I had a million things to think about, but figured I should still get a few hours" sleep while I still could.

I could see Val and Bottle of whiskey here.

>w
I couldn't go that way.

>e
I couldn't go that way.

>look
PC_Bedroom
I checked my watch, it was getting late, almost noon. I had a million things to think about, but figured I should still get a few hours" sleep while I still could.

I could see Val and Bottle of whiskey here.

>w
I couldn't go that way.

>scenes
Scene 'Entire Game' playing (for 32 mins now)
Scene 'Mountain_Driving' ended
Scene 'Car_Escape' ended
Scene 'Cliff_Climbing' ended
Scene 'Car_Embarking' ended
Scene 'Riding_Scene' ended
Scene 'Body_Discovery' ended
Scene 'Prearrival' playing (for 20 mins now)
(Scene monitoring now switched on. Type "scenes off" to switch it off again.)

>e
I couldn't go that way.

[Scene 'Guest_Arrival' begins]
I heard the front door open, and the sound of voices from the foyer. It closed a minute later.

[Scene 'Prearrival' ends]

>e
I couldn't go that way.

>w
I couldn't go that way.

>n
I couldn't go that way.

>u
I couldn't go that way.

>d
I couldn't go that way.

>e
I couldn't go that way.

I beg your pardon?

>look
PC_Bedroom
I checked my watch, it was getting late, almost noon. I had a million things to think about, but figured I should still get a few hours" sleep while I still could.

I could see Val and Bottle of whiskey here.

* * *

>w
I couldn't go that way.

>w
I couldn't go that way.

>look
PC_Bedroom
I checked my watch, it was getting late, almost noon. I had a million things to think about, but figured I should still get a few hours" sleep while I still could.

I could see Val and Bottle of whiskey here.

>exits
south through PC_Bedroom_Door to Upstairs Hallway

>s
Upstairs Hallway

>w
I couldn't go that way.

>d
Downstairs Hallway

>w
Greatroom
The greatroom was clearly where the occupants of the house were meant to spend the majority of their time. Tall dark rafters criscrossed the high ceiling, the exposed beams clearly meant to evoke a Swiss chalet.

A large set of sofas were arranged around a huge rug. A dark stain was conspicuous against the pattern of the fabric. Everything in the room faced a gray slate fireplace. A fire roared inside, fresh logs having been added not too long ago.

A small spiral staircase in the corner led up to a reading nook, which was open to the greatroom, separated by a wooden balustrade. Coming from somewhere up there I could hear "Hark, The Herald Angels Sing" warbling from what sounded like an old radio.

>w
Foyer
I walked into the spacious foyer, trying not to walk into the large lacquered screens in front of the door. The shiny black wood was decorated with an intricate picture in gold paint, depicting a Chinese court scene. It seemed at odds with the exterior of the house, but matched the rest of the decor; the interior was a mixture of Old World furniture and Asian influences.

A layer of snow had blown in through the open doorway, and was slowly melting into a puddle on the enormous Persian rug.

Three men stood on the rug, their coats and pant cuffs damp with snow. Val made introductions all around, as if nothing was wrong. Jan Svennson was a broad-shouldered man with pale blue eyes. He was casually brushing snow off a European performance fleece sweater. Either he liked ice climbing, or he wanted people to think he did. He had the handshake of a salesman and the grin of a frat boy.

Scott Gage, on the other hand, was tall and lanky, and didn't seem at all suited to the cold. He wore a pair of Japanese selvedge jeans with the cuffs turned up to make sure everyone knew it. I'd have guessed he'd picked them up somewhere in SoHo if it weren't for the sweater he was wearing, useless against real cold, as all Californian sweaters are. 

I studied their faces carefully. If one of them knew about Alan upstairs, they weren't letting on. The three men were overdressed for vacation, as rich men often are. But somehow, they were oddly mismatched. I doubted that they came here together.

>w
[Scene 'Guest_Arrival' ends]
[Scene 'First_Investigation' begins]
[Scene 'First_Investigation' ends]
[Scene 'First_Sleep' begins]

* * *

>w
Foyer
I walked into the spacious foyer, trying not to walk into the large lacquered screens in front of the door. The shiny black wood was decorated with an intricate picture in gold paint, depicting a Chinese court scene. It seemed at odds with the exterior of the house, but matched the rest of the decor; the interior was a mixture of Old World furniture and Asian influences.

A layer of snow had blown in through the open doorway, and was slowly melting into a puddle on the enormous Persian rug.

Three men stood on the rug, their coats and pant cuffs damp with snow. Val made introductions all around, as if nothing was wrong. Jan Svennson was a broad-shouldered man with pale blue eyes. He was casually brushing snow off a European performance fleece sweater. Either he liked ice climbing, or he wanted people to think he did. He had the handshake of a salesman and the grin of a frat boy.

Scott Gage, on the other hand, was tall and lanky, and didn't seem at all suited to the cold. He wore a pair of Japanese selvedge jeans with the cuffs turned up to make sure everyone knew it. I'd have guessed he'd picked them up somewhere in SoHo if it weren't for the sweater he was wearing, useless against real cold, as all Californian sweaters are. 

I studied their faces carefully. If one of them knew about Alan upstairs, they weren't letting on. The three men were overdressed for vacation, as rich men often are. But somehow, they were oddly mismatched. I doubted that they came here together.

>e
Foyer
I walked into the spacious foyer, trying not to walk into the large lacquered screens in front of the door. The shiny black wood was decorated with an intricate picture in gold paint, depicting a Chinese court scene. It seemed at odds with the exterior of the house, but matched the rest of the decor; the interior was a mixture of Old World furniture and Asian influences.

A layer of snow had blown in through the open doorway, and was slowly melting into a puddle on the enormous Persian rug.

Three men stood on the rug, their coats and pant cuffs damp with snow. Val made introductions all around, as if nothing was wrong. Jan Svennson was a broad-shouldered man with pale blue eyes. He was casually brushing snow off a European performance fleece sweater. Either he liked ice climbing, or he wanted people to think he did. He had the handshake of a salesman and the grin of a frat boy.

Scott Gage, on the other hand, was tall and lanky, and didn't seem at all suited to the cold. He wore a pair of Japanese selvedge jeans with the cuffs turned up to make sure everyone knew it. I'd have guessed he'd picked them up somewhere in SoHo if it weren't for the sweater he was wearing, useless against real cold, as all Californian sweaters are. 

I studied their faces carefully. If one of them knew about Alan upstairs, they weren't letting on. The three men were overdressed for vacation, as rich men often are. But somehow, they were oddly mismatched. I doubted that they came here together.

I beg your pardon?

>e
Foyer
I walked into the spacious foyer, trying not to walk into the large lacquered screens in front of the door. The shiny black wood was decorated with an intricate picture in gold paint, depicting a Chinese court scene. It seemed at odds with the exterior of the house, but matched the rest of the decor; the interior was a mixture of Old World furniture and Asian influences.

A layer of snow had blown in through the open doorway, and was slowly melting into a puddle on the enormous Persian rug.

Three men stood on the rug, their coats and pant cuffs damp with snow. Val made introductions all around, as if nothing was wrong. Jan Svennson was a broad-shouldered man with pale blue eyes. He was casually brushing snow off a European performance fleece sweater. Either he liked ice climbing, or he wanted people to think he did. He had the handshake of a salesman and the grin of a frat boy.

Scott Gage, on the other hand, was tall and lanky, and didn't seem at all suited to the cold. He wore a pair of Japanese selvedge jeans with the cuffs turned up to make sure everyone knew it. I'd have guessed he'd picked them up somewhere in SoHo if it weren't for the sweater he was wearing, useless against real cold, as all Californian sweaters are. 

I studied their faces carefully. If one of them knew about Alan upstairs, they weren't letting on. The three men were overdressed for vacation, as rich men often are. But somehow, they were oddly mismatched. I doubted that they came here together.

>e
Foyer
I walked into the spacious foyer, trying not to walk into the large lacquered screens in front of the door. The shiny black wood was decorated with an intricate picture in gold paint, depicting a Chinese court scene. It seemed at odds with the exterior of the house, but matched the rest of the decor; the interior was a mixture of Old World furniture and Asian influences.

A layer of snow had blown in through the open doorway, and was slowly melting into a puddle on the enormous Persian rug.

Three men stood on the rug, their coats and pant cuffs damp with snow. Val made introductions all around, as if nothing was wrong. Jan Svennson was a broad-shouldered man with pale blue eyes. He was casually brushing snow off a European performance fleece sweater. Either he liked ice climbing, or he wanted people to think he did. He had the handshake of a salesman and the grin of a frat boy.

Scott Gage, on the other hand, was tall and lanky, and didn't seem at all suited to the cold. He wore a pair of Japanese selvedge jeans with the cuffs turned up to make sure everyone knew it. I'd have guessed he'd picked them up somewhere in SoHo if it weren't for the sweater he was wearing, useless against real cold, as all Californian sweaters are. 

I studied their faces carefully. If one of them knew about Alan upstairs, they weren't letting on. The three men were overdressed for vacation, as rich men often are. But somehow, they were oddly mismatched. I doubted that they came here together.

>w
Foyer
I walked into the spacious foyer, trying not to walk into the large lacquered screens in front of the door. The shiny black wood was decorated with an intricate picture in gold paint, depicting a Chinese court scene. It seemed at odds with the exterior of the house, but matched the rest of the decor; the interior was a mixture of Old World furniture and Asian influences.

A layer of snow had blown in through the open doorway, and was slowly melting into a puddle on the enormous Persian rug.

Three men stood on the rug, their coats and pant cuffs damp with snow. Val made introductions all around, as if nothing was wrong. Jan Svennson was a broad-shouldered man with pale blue eyes. He was casually brushing snow off a European performance fleece sweater. Either he liked ice climbing, or he wanted people to think he did. He had the handshake of a salesman and the grin of a frat boy.

Scott Gage, on the other hand, was tall and lanky, and didn't seem at all suited to the cold. He wore a pair of Japanese selvedge jeans with the cuffs turned up to make sure everyone knew it. I'd have guessed he'd picked them up somewhere in SoHo if it weren't for the sweater he was wearing, useless against real cold, as all Californian sweaters are. 

I studied their faces carefully. If one of them knew about Alan upstairs, they weren't letting on. The three men were overdressed for vacation, as rich men often are. But somehow, they were oddly mismatched. I doubted that they came here together.

>scenes
Scene 'Entire Game' playing (for 24 mins now)
Scene 'Mountain_Driving' ended
Scene 'Car_Escape' ended
Scene 'Cliff_Climbing' ended
Scene 'Car_Embarking' ended
Scene 'Riding_Scene' ended
Scene 'Body_Discovery' playing (for 17 mins now)
(Scene monitoring now switched on. Type "scenes off" to switch it off again.)

>scope
1: myself (747301)
2: Val (748069)
3: a cell phone (747333)

>values
That noun did not make sense in this context.

>e
Foyer
I walked into the spacious foyer, trying not to walk into the large lacquered screens in front of the door. The shiny black wood was decorated with an intricate picture in gold paint, depicting a Chinese court scene. It seemed at odds with the exterior of the house, but matched the rest of the decor; the interior was a mixture of Old World furniture and Asian influences.

A layer of snow had blown in through the open doorway, and was slowly melting into a puddle on the enormous Persian rug.

Three men stood on the rug, their coats and pant cuffs damp with snow. Val made introductions all around, as if nothing was wrong. Jan Svennson was a broad-shouldered man with pale blue eyes. He was casually brushing snow off a European performance fleece sweater. Either he liked ice climbing, or he wanted people to think he did. He had the handshake of a salesman and the grin of a frat boy.

Scott Gage, on the other hand, was tall and lanky, and didn't seem at all suited to the cold. He wore a pair of Japanese selvedge jeans with the cuffs turned up to make sure everyone knew it. I'd have guessed he'd picked them up somewhere in SoHo if it weren't for the sweater he was wearing, useless against real cold, as all Californian sweaters are. 

I studied their faces carefully. If one of them knew about Alan upstairs, they weren't letting on. The three men were overdressed for vacation, as rich men often are. But somehow, they were oddly mismatched. I doubted that they came here together.

>n
I couldn't go that way.

* * *

>u
I couldn't go that way.

>e
Foyer
I walked into the spacious foyer, trying not to walk into the large lacquered screens in front of the door. The shiny black wood was decorated with an intricate picture in gold paint, depicting a Chinese court scene. It seemed at odds with the exterior of the house, but matched the rest of the decor; the interior was a mixture of Old World furniture and Asian influences.

A layer of snow had blown in through the open doorway, and was slowly melting into a puddle on the enormous Persian rug.

Three men stood on the rug, their coats and pant cuffs damp with snow. Val made introductions all around, as if nothing was wrong. Jan Svennson was a broad-shouldered man with pale blue eyes. He was casually brushing snow off a European performance fleece sweater. Either he liked ice climbing, or he wanted people to think he did. He had the handshake of a salesman and the grin of a frat boy.

Scott Gage, on the other hand, was tall and lanky, and didn't seem at all suited to the cold. He wore a pair of Japanese selvedge jeans with the cuffs turned up to make sure everyone knew it. I'd have guessed he'd picked them up somewhere in SoHo if it weren't for the sweater he was wearing, useless against real cold, as all Californian sweaters are. 

I studied their faces carefully. If one of them knew about Alan upstairs, they weren't letting on. The three men were overdressed for vacation, as rich men often are. But somehow, they were oddly mismatched. I doubted that they came here together.

>look
Foyer
I walked into the spacious foyer, trying not to walk into the large lacquered screens in front of the door. The shiny black wood was decorated with an intricate picture in gold paint, depicting a Chinese court scene. It seemed at odds with the exterior of the house, but matched the rest of the decor; the interior was a mixture of Old World furniture and Asian influences.

A layer of snow had blown in through the open doorway, and was slowly melting into a puddle on the enormous Persian rug.

Three men stood on the rug, their coats and pant cuffs damp with snow. Val made introductions all around, as if nothing was wrong. Jan Svennson was a broad-shouldered man with pale blue eyes. He was casually brushing snow off a European performance fleece sweater. Either he liked ice climbing, or he wanted people to think he did. He had the handshake of a salesman and the grin of a frat boy.

Scott Gage, on the other hand, was tall and lanky, and didn't seem at all suited to the cold. He wore a pair of Japanese selvedge jeans with the cuffs turned up to make sure everyone knew it. I'd have guessed he'd picked them up somewhere in SoHo if it weren't for the sweater he was wearing, useless against real cold, as all Californian sweaters are. 

I studied their faces carefully. If one of them knew about Alan upstairs, they weren't letting on. The three men were overdressed for vacation, as rich men often are. But somehow, they were oddly mismatched. I doubted that they came here together.

>w
Foyer
I walked into the spacious foyer, trying not to walk into the large lacquered screens in front of the door. The shiny black wood was decorated with an intricate picture in gold paint, depicting a Chinese court scene. It seemed at odds with the exterior of the house, but matched the rest of the decor; the interior was a mixture of Old World furniture and Asian influences.

A layer of snow had blown in through the open doorway, and was slowly melting into a puddle on the enormous Persian rug.

Three men stood on the rug, their coats and pant cuffs damp with snow. Val made introductions all around, as if nothing was wrong. Jan Svennson was a broad-shouldered man with pale blue eyes. He was casually brushing snow off a European performance fleece sweater. Either he liked ice climbing, or he wanted people to think he did. He had the handshake of a salesman and the grin of a frat boy.

Scott Gage, on the other hand, was tall and lanky, and didn't seem at all suited to the cold. He wore a pair of Japanese selvedge jeans with the cuffs turned up to make sure everyone knew it. I'd have guessed he'd picked them up somewhere in SoHo if it weren't for the sweater he was wearing, useless against real cold, as all Californian sweaters are. 

I studied their faces carefully. If one of them knew about Alan upstairs, they weren't letting on. The three men were overdressed for vacation, as rich men often are. But somehow, they were oddly mismatched. I doubted that they came here together.

>scenes
Scene 'Entire Game' playing (for 33 mins now)
Scene 'Mountain_Driving' ended
Scene 'Car_Escape' ended
Scene 'Cliff_Climbing' ended
Scene 'Car_Embarking' ended
Scene 'Riding_Scene' ended
Scene 'Body_Discovery' playing (for 26 mins now)
(Scene monitoring now switched on. Type "scenes off" to switch it off again.)

>e
Foyer
I walked into the spacious foyer, trying not to walk into the large lacquered screens in front of the door. The shiny black wood was decorated with an intricate picture in gold paint, depicting a Chinese court scene. It seemed at odds with the exterior of the house, but matched the rest of the decor; the interior was a mixture of Old World furniture and Asian influences.

A layer of snow had blown in through the open doorway, and was slowly melting into a puddle on the enormous Persian rug.

Three men stood on the rug, their coats and pant cuffs damp with snow. Val made introductions all around, as if nothing was wrong. Jan Svennson was a broad-shouldered man with pale blue eyes. He was casually brushing snow off a European performance fleece sweater. Either he liked ice climbing, or he wanted people to think he did. He had the handshake of a salesman and the grin of a frat boy.

Scott Gage, on the other hand, was tall and lanky, and didn't seem at all suited to the cold. He wore a pair of Japanese selvedge jeans with the cuffs turned up to make sure everyone knew it. I'd have guessed he'd picked them up somewhere in SoHo if it weren't for the sweater he was wearing, useless against real cold, as all Californian sweaters are. 

I studied their faces carefully. If one of them knew about Alan upstairs, they weren't letting on. The three men were overdressed for vacation, as rich men often are. But somehow, they were oddly mismatched. I doubted that they came here together.

* * *

>n
I couldn't go that way.

* * *

>d
I couldn't go that way.

>e
Foyer
I walked into the spacious foyer, trying not to walk into the large lacquered screens in front of the door. The shiny black wood was decorated with an intricate picture in gold paint, depicting a Chinese court scene. It seemed at odds with the exterior of the house, but matched the rest of the decor; the interior was a mixture of Old World furniture and Asian influences.

A layer of snow had blown in through the open doorway, and was slowly melting into a puddle on the enormous Persian rug.

Three men stood on the rug, their coats and pant cuffs damp with snow. Val made introductions all around, as if nothing was wrong. Jan Svennson was a broad-shouldered man with pale blue eyes. He was casually brushing snow off a European performance fleece sweater. Either he liked ice climbing, or he wanted people to think he did. He had the handshake of a salesman and the grin of a frat boy.

Scott Gage, on the other hand, was tall and lanky, and didn't seem at all suited to the cold. He wore a pair of Japanese selvedge jeans with the cuffs turned up to make sure everyone knew it. I'd have guessed he'd picked them up somewhere in SoHo if it weren't for the sweater he was wearing, useless against real cold, as all Californian sweaters are. 

I studied their faces carefully. If one of them knew about Alan upstairs, they weren't letting on. The three men were overdressed for vacation, as rich men often are. But somehow, they were oddly mismatched. I doubted that they came here together.

* * *

>e
Greatroom
The greatroom was clearly where the occupants of the house were meant to spend the majority of their time. Tall dark rafters criscrossed the high ceiling, the exposed beams clearly meant to evoke a Swiss chalet.

A large set of sofas were arranged around a huge rug. A dark stain was conspicuous against the pattern of the fabric. Everything in the room faced a gray slate fireplace. A fire roared inside, fresh logs having been added not too long ago.

A small spiral staircase in the corner led up to a reading nook, which was open to the greatroom, separated by a wooden balustrade. Coming from somewhere up there I could hear "O Come, All Ye Faithful" warbling from what sounded like an old radio.

I beg your pardon?

* * *

>scenes
Scene 'Entire Game' playing (for 23 mins now)
Scene 'Mountain_Driving' ended
Scene 'Car_Escape' ended
Scene 'Cliff_Climbing' ended
Scene 'Car_Embarking' ended
Scene 'Riding_Scene' ended
Scene 'Body_Discovery' playing (for 16 mins now)
(Scene monitoring now switched on. Type "scenes off" to switch it off again.)

>scope
1: myself (747301)
2: Val (748069)
3: a cell phone (747333)

* * *

>n
I couldn't go that way.

* * *

>look
Foyer
I walked into the spacious foyer, trying not to walk into the large lacquered screens in front of the door. The shiny black wood was decorated with an intricate picture in gold paint, depicting a Chinese court scene. It seemed at odds with the exterior of the house, but matched the rest of the decor; the interior was a mixture of Old World furniture and Asian influences.

A layer of snow had blown in through the open doorway, and was slowly melting into a puddle on the enormous Persian rug.

Three men stood on the rug, their coats and pant cuffs damp with snow. Val made introductions all around, as if nothing was wrong. Jan Svennson was a broad-shouldered man with pale blue eyes. He was casually brushing snow off a European performance fleece sweater. Either he liked ice climbing, or he wanted people to think he did. He had the handshake of a salesman and the grin of a frat boy.

Scott Gage, on the other hand, was tall and lanky, and didn't seem at all suited to the cold. He wore a pair of Japanese selvedge jeans with the cuffs turned up to make sure everyone knew it. I'd have guessed he'd picked them up somewhere in SoHo if it weren't for the sweater he was wearing, useless against real cold, as all Californian sweaters are. 

I studied their faces carefully. If one of them knew about Alan upstairs, they weren't letting on. The three men were overdressed for vacation, as rich men often are. But somehow, they were oddly mismatched. I doubted that they came here together.

* * *

>scenes
Scene 'Entire Game' playing (for 32 mins now)
Scene 'Mountain_Driving' ended
Scene 'Car_Escape' ended
Scene 'Cliff_Climbing' ended
Scene 'Car_Embarking' ended
Scene 'Riding_Scene' ended
Scene 'Body_Discovery' playing (for 25 mins now)
(Scene monitoring now switched on. Type "scenes off" to switch it off again.)

* * *

I beg your pardon?

>look
Foyer
I walked into the spacious foyer, trying not to walk into the large lacquered screens in front of the door. The shiny black wood was decorated with an intricate picture in gold paint, depicting a Chinese court scene. It seemed at odds with the exterior of the house, but matched the rest of the decor; the interior was a mixture of Old World furniture and Asian influences.

A layer of snow had blown in through the open doorway, and was slowly melting into a puddle on the enormous Persian rug.

Three men stood on the rug, their coats and pant cuffs damp with snow. Val made introductions all around, as if nothing was wrong. Jan Svennson was a broad-shouldered man with pale blue eyes. He was casually brushing snow off a European performance fleece sweater. Either he liked ice climbing, or he wanted people to think he did. He had the handshake of a salesman and the grin of a frat boy.

Scott Gage, on the other hand, was tall and lanky, and didn't seem at all suited to the cold. He wore a pair of Japanese selvedge jeans with the cuffs turned up to make sure everyone knew it. I'd have guessed he'd picked them up somewhere in SoHo if it weren't for the sweater he was wearing, useless against real cold, as all Californian sweaters are. 

I studied their faces carefully. If one of them knew about Alan upstairs, they weren't letting on. The three men were overdressed for vacation, as rich men often are. But somehow, they were oddly mismatched. I doubted that they came here together.

* * *

>w
Foyer
I walked into the spacious foyer, trying not to walk into the large lacquered screens in front of the door. The shiny black wood was decorated with an intricate picture in gold paint, depicting a Chinese court scene. It seemed at odds with the exterior of the house, but matched the rest of the decor; the interior was a mixture of Old World furniture and Asian influences.

A layer of snow had blown in through the open doorway, and was slowly melting into a puddle on the enormous Persian rug.

Three men stood on the rug, their coats and pant cuffs damp with snow. Val made introductions all around, as if nothing was wrong. Jan Svennson was a broad-shouldered man with pale blue eyes. He was casually brushing snow off a European performance fleece sweater. Either he liked ice climbing, or he wanted people to think he did. He had the handshake of a salesman and the grin of a frat boy.

Scott Gage, on the other hand, was tall and lanky, and didn't seem at all suited to the cold. He wore a pair of Japanese selvedge jeans with the cuffs turned up to make sure everyone knew it. I'd have guessed he'd picked them up somewhere in SoHo if it weren't for the sweater he was wearing, useless against real cold, as all Californian sweaters are. 

I studied their faces carefully. If one of them knew about Alan upstairs, they weren't letting on. The three men were overdressed for vacation, as rich men often are. But somehow, they were oddly mismatched. I doubted that they came here together.

>scenes
Scene 'Entire Game' playing (for 25 mins now)
Scene 'Mountain_Driving' ended
Scene 'Car_Escape' ended
Scene 'Cliff_Climbing' ended
Scene 'Car_Embarking' ended
Scene 'Riding_Scene' ended
Scene 'Body_Discovery' playing (for 18 mins now)
(Scene monitoring now switched on. Type "scenes off" to switch it off again.)

>scope
1: myself (747045)
2: Val (747813)
3: a cell phone (747077)

>values
That noun did not make sense in this context.

* * *

>scenes
Scene 'Entire Game' playing (for 34 mins now)
Scene 'Mountain_Driving' ended
Scene 'Car_Escape' ended
Scene 'Cliff_Climbing' ended
Scene 'Car_Embarking' ended
Scene 'Riding_Scene' ended
Scene 'Body_Discovery' playing (for 27 mins now)
(Scene monitoring now switched on. Type "scenes off" to switch it off again.)

>e
Foyer
I walked into the spacious foyer, trying not to walk into the large lacquered screens in front of the door. The shiny black wood was decorated with an intricate picture in gold paint, depicting a Chinese court scene. It seemed at odds with the exterior of the house, but matched the rest of the decor; the interior was a mixture of Old World furniture and Asian influences.

A layer of snow had blown in through the open doorway, and was slowly melting into a puddle on the enormous Persian rug.

Three men stood on the rug, their coats and pant cuffs damp with snow. Val made introductions all around, as if nothing was wrong. Jan Svennson was a broad-shouldered man with pale blue eyes. He was casually brushing snow off a European performance fleece sweater. Either he liked ice climbing, or he wanted people to think he did. He had the handshake of a salesman and the grin of a frat boy.

Scott Gage, on the other hand, was tall and lanky, and didn't seem at all suited to the cold. He wore a pair of Japanese selvedge jeans with the cuffs turned up to make sure everyone knew it. I'd have guessed he'd picked them up somewhere in SoHo if it weren't for the sweater he was wearing, useless against real cold, as all Californian sweaters are. 

I studied their faces carefully. If one of them knew about Alan upstairs, they weren't letting on. The three men were overdressed for vacation, as rich men often are. But somehow, they were oddly mismatched. I doubted that they came here together.

* * *

>e
Downstairs Hallway

* * *

>e
I couldn't go that way.

>w
Greatroom
The greatroom was clearly where the occupants of the house were meant to spend the majority of their time. Tall dark rafters criscrossed the high ceiling, the exposed beams clearly meant to evoke a Swiss chalet.

A large set of sofas were arranged around a huge rug. A dark stain was conspicuous against the pattern of the fabric. Everything in the room faced a gray slate fireplace. A fire roared inside, fresh logs having been added not too long ago.

A small spiral staircase in the corner led up to a reading nook, which was open to the greatroom, separated by a wooden balustrade. Coming from somewhere up there I could hear "Hark, The Herald Angels Sing" warbling from what sounded like an old radio.

>e
Downstairs Hallway

>w
Greatroom
The greatroom was clearly where the occupants of the house were meant to spend the majority of their time. Tall dark rafters criscrossed the high ceiling, the exposed beams clearly meant to evoke a Swiss chalet.

A large set of sofas were arranged around a huge rug. A dark stain was conspicuous against the pattern of the fabric. Everything in the room faced a gray slate fireplace. A fire roared inside, fresh logs having been added not too long ago.

A small spiral staircase in the corner led up to a reading nook, which was open to the greatroom, separated by a wooden balustrade. Coming from somewhere up there I could hear "We Three Kings" warbling from what sounded like an old radio.

>scenes
Scene 'Entire Game' playing (for 23 mins now)
Scene 'Mountain_Driving' ended
Scene 'Car_Escape' ended
Scene 'Cliff_Climbing' ended
Scene 'Car_Embarking' ended
Scene 'Riding_Scene' ended
Scene 'Body_Discovery' ended
Scene 'Prearrival' playing (for 11 mins now)
(Scene monitoring now switched on. Type "scenes off" to switch it off again.)

>scope
1: myself (747301)
2: a stain (748325)
3: a sofa (748357)
4: a cell phone (747333)

>values
That noun did not make sense in this context.

* * *

>d
Downstairs Hallway

>w
Greatroom
The greatroom was clearly where the occupants of the house were meant to spend the majority of their time. Tall dark rafters criscrossed the high ceiling, the exposed beams clearly meant to evoke a Swiss chalet.

A large set of sofas were arranged around a huge rug. A dark stain was conspicuous against the pattern of the fabric. Everything in the room faced a gray slate fireplace. A fire roared inside, fresh logs having been added not too long ago.

A small spiral staircase in the corner led up to a reading nook, which was open to the greatroom, separated by a wooden balustrade. Coming from somewhere up there I could hear "We Three Kings" warbling from what sounded like an old radio.

>w
Foyer
I walked into the spacious foyer, trying not to walk into the large lacquered screens in front of the door. The shiny black wood was decorated with an intricate picture in gold paint, depicting a Chinese court scene. It seemed at odds with the exterior of the house, but matched the rest of the decor; the interior was a mixture of Old World furniture and Asian influences.

A layer of snow had blown in through the open doorway, and was slowly melting into a puddle on the enormous Persian rug.

Three men stood on the rug, their coats and pant cuffs damp with snow. Val made introductions all around, as if nothing was wrong. Jan Svennson was a broad-shouldered man with pale blue eyes. He was casually brushing snow off a European performance fleece sweater. Either he liked ice climbing, or he wanted people to think he did. He had the handshake of a salesman and the grin of a frat boy.

Scott Gage, on the other hand, was tall and lanky, and didn't seem at all suited to the cold. He wore a pair of Japanese selvedge jeans with the cuffs turned up to make sure everyone knew it. I'd have guessed he'd picked them up somewhere in SoHo if it weren't for the sweater he was wearing, useless against real cold, as all Californian sweaters are. 

I studied their faces carefully. If one of them knew about Alan upstairs, they weren't letting on. The three men were overdressed for vacation, as rich men often are. But somehow, they were oddly mismatched. I doubted that they came here together.

* * *

>scenes
Scene 'Entire Game' playing (for 15 mins now)
Scene 'Mountain_Driving' ended
Scene 'Car_Escape' ended
Scene 'Cliff_Climbing' ended
Scene 'Car_Embarking' ended
Scene 'Riding_Scene' ended
Scene 'Body_Discovery' playing (for 8 mins now)
(Scene monitoring now switched on. Type "scenes off" to switch it off again.)

* * *

>scenes
Scene 'Entire Game' playing (for 26 mins now)
Scene 'Mountain_Driving' ended
Scene 'Car_Escape' ended
Scene 'Cliff_Climbing' ended
Scene 'Car_Embarking' ended
Scene 'Riding_Scene' ended
Scene 'Body_Discovery' playing (for 19 mins now)
(Scene monitoring now switched on. Type "scenes off" to switch it off again.)

>scope
1: myself (747301)
2: Val (748069)
3: a cell phone (747333)

* * *

>scenes
Scene 'Entire Game' playing (for 35 mins now)
Scene 'Mountain_Driving' ended
Scene 'Car_Escape' ended
Scene 'Cliff_Climbing' ended
Scene 'Car_Embarking' ended
Scene 'Riding_Scene' ended
Scene 'Body_Discovery' playing (for 28 mins now)
(Scene monitoring now switched on. Type "scenes off" to switch it off again.)

* * *

>scenes
Scene 'Entire Game' playing (for 14 mins now)
Scene 'Mountain_Driving' ended
Scene 'Car_Escape' ended
Scene 'Cliff_Climbing' ended
Scene 'Car_Embarking' ended
Scene 'Riding_Scene' ended
Scene 'Body_Discovery' playing (for 7 mins now)
(Scene monitoring now switched on. Type "scenes off" to switch it off again.)

* * *

>scenes
Scene 'Entire Game' playing (for 25 mins now)
Scene 'Mountain_Driving' ended
Scene 'Car_Escape' ended
Scene 'Cliff_Climbing' ended
Scene 'Car_Embarking' ended
Scene 'Riding_Scene' ended
Scene 'Body_Discovery' playing (for 18 mins now)
(Scene monitoring now switched on. Type "scenes off" to switch it off again.)

* * *

>scenes
Scene 'Entire Game' playing (for 34 mins now)
Scene 'Mountain_Driving' ended
Scene 'Car_Escape' ended
Scene 'Cliff_Climbing' ended
Scene 'Car_Embarking' ended
Scene 'Riding_Scene' ended
Scene 'Body_Discovery' playing (for 27 mins now)
(Scene monitoring now switched on. Type "scenes off" to switch it off again.)

* * *

>look
Foyer
I walked into the spacious foyer, trying not to walk into the large lacquered screens in front of the door. The shiny black wood was decorated with an intricate picture in gold paint, depicting a Chinese court scene. It seemed at odds with the exterior of the house, but matched the rest of the decor; the interior was a mixture of Old World furniture and Asian influences.

A layer of snow had blown in through the open doorway, and was slowly melting into a puddle on the enormous Persian rug.

Three men stood on the rug, their coats and pant cuffs damp with snow. Val made introductions all around, as if nothing was wrong. Jan Svennson was a broad-shouldered man with pale blue eyes. He was casually brushing snow off a European performance fleece sweater. Either he liked ice climbing, or he wanted people to think he did. He had the handshake of a salesman and the grin of a frat boy.

Scott Gage, on the other hand, was tall and lanky, and didn't seem at all suited to the cold. He wore a pair of Japanese selvedge jeans with the cuffs turned up to make sure everyone knew it. I'd have guessed he'd picked them up somewhere in SoHo if it weren't for the sweater he was wearing, useless against real cold, as all Californian sweaters are. 

I studied their faces carefully. If one of them knew about Alan upstairs, they weren't letting on. The three men were overdressed for vacation, as rich men often are. But somehow, they were oddly mismatched. I doubted that they came here together.

* * *

>scenes
Scene 'Entire Game' playing (for 16 mins now)
Scene 'Mountain_Driving' ended
Scene 'Car_Escape' ended
Scene 'Cliff_Climbing' ended
Scene 'Car_Embarking' ended
Scene 'Riding_Scene' ended
Scene 'Body_Discovery' playing (for 9 mins now)
(Scene monitoring now switched on. Type "scenes off" to switch it off again.)

* * *

>scenes
Scene 'Entire Game' playing (for 27 mins now)
Scene 'Mountain_Driving' ended
Scene 'Car_Escape' ended
Scene 'Cliff_Climbing' ended
Scene 'Car_Embarking' ended
Scene 'Riding_Scene' ended
Scene 'Body_Discovery' playing (for 20 mins now)
(Scene monitoring now switched on. Type "scenes off" to switch it off again.)

>scope
1: myself (747045)
2: Val (747813)
3: a cell phone (747077)

* * *

>up
I couldn't go that way.

>turn off radio
I switched the radio off.

>look
Reading Nook
I climbed the stairs to the reading nook. Shelves lined the walls of the small room, and a couple of books had been knocked off them onto the floor. A pair of wingback armchairs faced each other with a coffee table in between.

A man sat in one, slightly paunchy and slightly grey, his eyes and mouth wide open. His glasses were askew. He was wearing a wool cardigan, stained on the front with a dark, almost black liquid. What looked like a large carving knife was sticking out of his chest, plunged in so far that only the handle was visible.

An antique wooden radio sat on the table.

I could also see a bottle of wine here.

>x val
I couldn't see any such thing.

>help
That noun did not make sense in this context.

>debug
That noun did not make sense in this context.

>scenes
Scene 'Entire Game' playing (for 15 mins now)
Scene 'Mountain_Driving' ended
Scene 'Car_Escape' ended
Scene 'Cliff_Climbing' ended
Scene 'Car_Embarking' ended
Scene 'Riding_Scene' ended
Scene 'Body_Discovery' playing (for 8 mins now)
(Scene monitoring now switched on. Type "scenes off" to switch it off again.)

>scope
1: myself (744737)
2: a body (745921)
3: a shelves (745953)
4: a books (745985)
5: a radio (746017)
6: a bottle of wine (746049)
7: a cell phone (744769)

>x val
I couldn't see any such thing.

>x Val
I couldn't see any such thing.

>x 2
I couldn't see any such thing.

>scope 2
There seems to be no such object anywhere in the model world.

>scoep
That noun did not make sense in this context.

>scope val
Who do you mean, Val or Val?

>x cell phone
I saw nothing special about the cell phone.

>x Val
I couldn't see any such thing.

>talk to Val
I couldn't see any such thing.

>x body
I could tell he didn't get out much. His skin was slightly pallid, and not just because he was dead.

[Scene 'Body_Discovery' ends]
Val came up the stairs, freezing the second she saw the body. Her eyes narrowed, and I could tell her mind was racing, the first time I'd seen anything but unflappable boredom on her face. Half of me was relieved to know that there was something in this world that could shock her. The other half was unnerved by it. She looked away and hitched the poker face back on pretty quick.

Val nodded at the poor stiff and said, "Meet Professor Alan Bowden, our host this weekend."
[Scene 'Prearrival' begins]

>w
I couldn't go that way.

>look
Reading Nook
I climbed the stairs to the reading nook. Shelves lined the walls of the small room, and a couple of books had been knocked off them onto the floor. A pair of wingback armchairs faced each other with a coffee table in between.

A man sat in one, slightly paunchy and slightly grey, his eyes and mouth wide open. His glasses were askew. He was wearing a wool cardigan, stained on the front with a dark, almost black liquid. What looked like a large carving knife was sticking out of his chest, plunged in so far that only the handle was visible.

Val stood here, looking impassively at what was left of Alan Bowden.

An antique wooden radio sat on the table.

I could also see a bottle of wine here.

>exits
down to Greatroom

>d
Greatroom
The greatroom was clearly where the occupants of the house were meant to spend the majority of their time. Tall dark rafters criscrossed the high ceiling, the exposed beams clearly meant to evoke a Swiss chalet.

A large set of sofas were arranged around a huge rug. A dark stain was conspicuous against the pattern of the fabric. Everything in the room faced a gray slate fireplace. A fire roared inside, fresh logs having been added not too long ago.

A small spiral staircase in the corner led up to a reading nook, which was open to the greatroom, separated by a wooden balustrade.

>exits
east, west to Foyer and up to Reading Nook

>e
Downstairs Hallway

>w
Greatroom
The greatroom was clearly where the occupants of the house were meant to spend the majority of their time. Tall dark rafters criscrossed the high ceiling, the exposed beams clearly meant to evoke a Swiss chalet.

A large set of sofas were arranged around a huge rug. A dark stain was conspicuous against the pattern of the fabric. Everything in the room faced a gray slate fireplace. A fire roared inside, fresh logs having been added not too long ago.

A small spiral staircase in the corner led up to a reading nook, which was open to the greatroom, separated by a wooden balustrade.

>x fireplace
I couldn't see any such thing.

>help
That noun did not make sense in this context.

>hint
That noun did not make sense in this context.

>x body
I couldn't see any such thing.

>u
Reading Nook
I climbed the stairs to the reading nook. Shelves lined the walls of the small room, and a couple of books had been knocked off them onto the floor. A pair of wingback armchairs faced each other with a coffee table in between.

A man sat in one, slightly paunchy and slightly grey, his eyes and mouth wide open. His glasses were askew. He was wearing a wool cardigan, stained on the front with a dark, almost black liquid. What looked like a large carving knife was sticking out of his chest, plunged in so far that only the handle was visible.

Val stood here, looking impassively at what was left of Alan Bowden.

An antique wooden radio sat on the table.

I could also see a bottle of wine here.

>x body
I could tell he didn't get out much. His skin was slightly pallid, and not just because he was dead.

>take wine
Taken.

>i
I was carrying:
  a bottle of wine
  a cell phone

>x wine
A Bordeaux from back in 2001. Expensive bottle to be drinking alone.

>x phone
I saw nothing special about the cell phone.

>take radio
I didn't see the point in carrying an old-fashioned wood radio with me.

>i
I was carrying:
  a bottle of wine
  a cell phone

>take all
radio: I didn't see the point in carrying an old-fashioned wood radio with me.

>i
I was carrying:
  a bottle of wine
  a cell phone

>look
Reading Nook
I climbed the stairs to the reading nook. Shelves lined the walls of the small room, and a couple of books had been knocked off them onto the floor. A pair of wingback armchairs faced each other with a coffee table in between.

A man sat in one, slightly paunchy and slightly grey, his eyes and mouth wide open. His glasses were askew. He was wearing a wool cardigan, stained on the front with a dark, almost black liquid. What looked like a large carving knife was sticking out of his chest, plunged in so far that only the handle was visible.

Val stood here, looking impassively at what was left of Alan Bowden.

An antique wooden radio sat on the table.

>x val
She wore a belted black overcoat with straight shoulders, which covered all of her except for the bottom of a long pencil skirt. She hadn't bothered taking her driving gloves off. I couldn't put my finger on it, but there was something stiffly formal and practised about the way she moved.

Her eyes rested on what was left of the professor, her expression unreadable.

>i
I was carrying:
  a bottle of wine
  a cell phone

[Scene 'Guest_Arrival' begins]
I heard the front door open, and the sound of voices from the foyer. It closed a minute later.
Val and I glanced at each other across the dead man, and she left back down the stairs.
[Scene 'Prearrival' ends]

>w
I couldn't go that way.

>d
Greatroom
The greatroom was clearly where the occupants of the house were meant to spend the majority of their time. Tall dark rafters criscrossed the high ceiling, the exposed beams clearly meant to evoke a Swiss chalet.

A large set of sofas were arranged around a huge rug. A dark stain was conspicuous against the pattern of the fabric. Everything in the room faced a gray slate fireplace. A fire roared inside, fresh logs having been added not too long ago.

A small spiral staircase in the corner led up to a reading nook, which was open to the greatroom, separated by a wooden balustrade.

>w
Foyer
I walked into the spacious foyer, trying not to walk into the large lacquered screens in front of the door. The shiny black wood was decorated with an intricate picture in gold paint, depicting a Chinese court scene. It seemed at odds with the exterior of the house, but matched the rest of the decor; the interior was a mixture of Old World furniture and Asian influences.

A layer of snow had blown in through the open doorway, and was slowly melting into a puddle on the enormous Persian rug.

* * *

>x val
I couldn't see any such thing.

* * *

>debug
That noun did not make sense in this context.

>scenes
Scene 'Entire Game' playing (for 12 mins now)
Scene 'Mountain_Driving' ended
Scene 'Car_Escape' ended
Scene 'Cliff_Climbing' ended
Scene 'Car_Embarking' ended
Scene 'Riding_Scene' ended
Scene 'Body_Discovery' playing (for 5 mins now)
(Scene monitoring now switched on. Type "scenes off" to switch it off again.)

>scope
1: myself (746533)
2: a body (747717)
3: a shelves (747749)
4: a books (747781)
5: a radio (747813)
6: a bottle of wine (747845)
7: a cell phone (746565)

>x val
I couldn't see any such thing.

* * *

>w
I couldn't go that way.

>look
Reading Nook
I climbed the stairs to the reading nook. Shelves lined the walls of the small room, and a couple of books had been knocked off them onto the floor. A pair of wingback armchairs faced each other with a coffee table in between.

A man sat in one, slightly paunchy and slightly grey, his eyes and mouth wide open. His glasses were askew. He was wearing a wool cardigan, stained on the front with a dark, almost black liquid. What looked like a large carving knife was sticking out of his chest, plunged in so far that only the handle was visible.

Val stood to my left, looking impassively at the body of Alan Bowden.

An antique wooden radio sat on the table, playing Christmas carols.

I could also see a bottle of wine here.

>exits
down to Greatroom

>d
Greatroom
The greatroom was clearly where the occupants of the house were meant to spend the majority of their time. Tall dark rafters criscrossed the high ceiling, the exposed beams clearly meant to evoke a Swiss chalet.

A large set of sofas were arranged around a huge rug. A dark stain was conspicuous against the pattern of the fabric. Everything in the room faced a gray slate fireplace. A fire roared inside, fresh logs having been added not too long ago.

A small spiral staircase in the corner led up to a reading nook, which was open to the greatroom, separated by a wooden balustrade. Coming from somewhere up there I could hear "Angels We Have Heard on High" warbling from what sounded like an old radio.

>exits
east, west to Foyer and up to Reading Nook

* * *

>e
Downstairs Hallway

>w
Greatroom
The greatroom was clearly where the occupants of the house were meant to spend the majority of their time. Tall dark rafters criscrossed the high ceiling, the exposed beams clearly meant to evoke a Swiss chalet.

A large set of sofas were arranged around a huge rug. A dark stain was conspicuous against the pattern of the fabric. Everything in the room faced a gray slate fireplace. A fire roared inside, fresh logs having been added not too long ago.

A small spiral staircase in the corner led up to a reading nook, which was open to the greatroom, separated by a wooden balustrade. Coming from somewhere up there I could hear "O Come, All Ye Faithful" warbling from what sounded like an old radio.

>x fireplace
I couldn't see any such thing.

* * *

>x body
I couldn't see any such thing.

>u
Reading Nook
I climbed the stairs to the reading nook. Shelves lined the walls of the small room, and a couple of books had been knocked off them onto the floor. A pair of wingback armchairs faced each other with a coffee table in between.

A man sat in one, slightly paunchy and slightly grey, his eyes and mouth wide open. His glasses were askew. He was wearing a wool cardigan, stained on the front with a dark, almost black liquid. What looked like a large carving knife was sticking out of his chest, plunged in so far that only the handle was visible.

Val stood to my left, looking impassively at the body of Alan Bowden.

An antique wooden radio sat on the table, playing Christmas carols.

I could also see a bottle of wine here.

>x body
I could tell he didn't get out much. His skin was slightly pallid, and not just because he was dead.

* * *

>i
I was carrying:
  a bottle of wine
  a cell phone

>x wine
A Bordeaux from back in 2001. It's uncorked and almost empty. Expensive bottle to be drinking alone.

>x phone
I saw nothing special about the cell phone.

* * *

>i
I was carrying:
  a bottle of wine
  a cell phone

>look
Reading Nook
I climbed the stairs to the reading nook. Shelves lined the walls of the small room, and a couple of books had been knocked off them onto the floor. A pair of wingback armchairs faced each other with a coffee table in between.

A man sat in one, slightly paunchy and slightly grey, his eyes and mouth wide open. His glasses were askew. He was wearing a wool cardigan, stained on the front with a dark, almost black liquid. What looked like a large carving knife was sticking out of his chest, plunged in so far that only the handle was visible.

Val stood to my left, looking impassively at the body of Alan Bowden.

An antique wooden radio sat on the table, playing Christmas carols.

>x val
She wore a belted black overcoat with straight shoulders, which covered all of her except for the bottom of a long pencil skirt. She hadn't bothered taking her driving gloves off. I couldn't put my finger on it, but there was something stiffly formal and practised about the way she moved.

Her eyes rested on what was left of the professor, her expression unreadable.

>i
I was carrying:
  a bottle of wine
  a cell phone

[Scene 'Guest_Arrival' begins]
I heard the front door open, and the sound of voices from the foyer. It closed a minute later.

Val and I glanced at each other across the dead man, and she left back down the stairs.
[Scene 'Prearrival' ends]

>w
I couldn't go that way.

>d
Greatroom
The greatroom was clearly where the occupants of the house were meant to spend the majority of their time. Tall dark rafters criscrossed the high ceiling, the exposed beams clearly meant to evoke a Swiss chalet.

A large set of sofas were arranged around a huge rug. A dark stain was conspicuous against the pattern of the fabric. Everything in the room faced a gray slate fireplace. A fire roared inside, fresh logs having been added not too long ago.

A small spiral staircase in the corner led up to a reading nook, which was open to the greatroom, separated by a wooden balustrade. Coming from somewhere up there I could hear "Angels We Have Heard on High" warbling from what sounded like an old radio.

>w
Foyer
I walked into the spacious foyer, trying not to walk into the large lacquered screens in front of the door. The shiny black wood was decorated with an intricate picture in gold paint, depicting a Chinese court scene. It seemed at odds with the exterior of the house, but matched the rest of the decor; the interior was a mixture of Old World furniture and Asian influences.

A layer of snow had blown in through the open doorway, and was slowly melting into a puddle on the enormous Persian rug.

Three men stood on the rug, their coats and pant cuffs damp with snow. Val made introductions all around, as if nothing was wrong. Jan Svennson was a broad-shouldered man with pale blue eyes. He was casually brushing snow off a European performance fleece sweater. Either he liked ice climbing, or he wanted people to think he did. He had the handshake of a salesman and the grin of a frat boy.

Scott Gage, on the other hand, was tall and lanky, and didn't seem at all suited to the cold. He wore a pair of Japanese selvedge jeans with the cuffs turned up to make sure everyone knew it. I'd have guessed he'd picked them up somewhere in SoHo if it weren't for the sweater he was wearing, useless against real cold, as all Californian sweaters are. 

I studied their faces carefully. If one of them knew about Alan upstairs, they weren't letting on. The three men were overdressed for vacation, as rich men often are. But somehow, they were oddly mismatched. I doubted that they came here together.

>w
Front Porch
Steps led up from the gravel driveway to the porch. Narrow unpainted wood planks extended the length of the house, along with windows that looked into rooms at the front of the house. Through them, I saw blinds, and a glint of something metallic.

>e
Foyer
I walked into the spacious foyer, trying not to walk into the large lacquered screens in front of the door. The shiny black wood was decorated with an intricate picture in gold paint, depicting a Chinese court scene. It seemed at odds with the exterior of the house, but matched the rest of the decor; the interior was a mixture of Old World furniture and Asian influences.

A layer of snow had blown in through the open doorway, and was slowly melting into a puddle on the enormous Persian rug.

Three men stood on the rug, their coats and pant cuffs damp with snow. Val made introductions all around, as if nothing was wrong. Jan Svennson was a broad-shouldered man with pale blue eyes. He was casually brushing snow off a European performance fleece sweater. Either he liked ice climbing, or he wanted people to think he did. He had the handshake of a salesman and the grin of a frat boy.

Scott Gage, on the other hand, was tall and lanky, and didn't seem at all suited to the cold. He wore a pair of Japanese selvedge jeans with the cuffs turned up to make sure everyone knew it. I'd have guessed he'd picked them up somewhere in SoHo if it weren't for the sweater he was wearing, useless against real cold, as all Californian sweaters are. 

I studied their faces carefully. If one of them knew about Alan upstairs, they weren't letting on. The three men were overdressed for vacation, as rich men often are. But somehow, they were oddly mismatched. I doubted that they came here together.

* * *

>take wine
Taken.

>x wine
A Bordeaux from back in 2001. It's uncorked and almost empty. Expensive bottle to be drinking alone.

* * *

>w
Foyer
I walked into the spacious foyer, trying not to walk into the large lacquered screens in front of the door. The shiny black wood was decorated with an intricate picture in gold paint, depicting a Chinese court scene. It seemed at odds with the exterior of the house, but matched the rest of the decor; the interior was a mixture of Old World furniture and Asian influences.

A layer of snow had blown in through the open doorway, and was slowly melting into a puddle on the enormous Persian rug.

Three men stood on the rug, their coats and pant cuffs damp with snow. Val made introductions all around, as if nothing was wrong. Jan Svennson was a broad-shouldered man with pale blue eyes. He was casually brushing snow off a European performance fleece sweater. Either he liked ice climbing, or he wanted people to think he did. He had the handshake of a salesman and the grin of a frat boy.

Scott Gage, on the other hand, was tall and lanky, and didn't seem at all suited to the cold. He wore a pair of Japanese selvedge jeans with the cuffs turned up to make sure everyone knew it. I'd have guessed he'd picked them up somewhere in SoHo if it weren't for the sweater he was wearing, useless against real cold, as all Californian sweaters are. 

I studied their faces carefully. If one of them knew about Alan upstairs, they weren't letting on. The three men were overdressed for vacation, as rich men often are. But somehow, they were oddly mismatched. I doubted that they came here together.

* * *

>e
Greatroom
The greatroom was clearly where the occupants of the house were meant to spend the majority of their time. Tall dark rafters criscrossed the high ceiling, the exposed beams clearly meant to evoke a Swiss chalet.

A large set of sofas were arranged around a huge rug. A dark stain was conspicuous against the pattern of the fabric. Everything in the room faced a gray slate fireplace. A fire roared inside, fresh logs having been added not too long ago.

A small spiral staircase in the corner led up to a reading nook, which was open to the greatroom, separated by a wooden balustrade. Coming from somewhere up there I could hear "Hark, The Herald Angels Sing" warbling from what sounded like an old radio.

* * *

>look
Reading Nook
I climbed the stairs to the reading nook. Shelves lined the walls of the small room, and a couple of books had been knocked off them onto the floor. A pair of wingback armchairs faced each other with a coffee table in between.

A man sat in one, slightly paunchy and slightly grey, his eyes and mouth wide open. His glasses were askew. He was wearing a wool cardigan, stained on the front with a dark, almost black liquid. What looked like a large carving knife was sticking out of his chest, plunged in so far that only the handle was visible.

An antique wooden radio sat on the table, playing Christmas carols.

I could also see a bottle of wine here.

>x val
I couldn't see any such thing.

* * *

>debug
That noun did not make sense in this context.

>scenes
Scene 'Entire Game' playing (for 13 mins now)
Scene 'Mountain_Driving' ended
Scene 'Car_Escape' ended
Scene 'Cliff_Climbing' ended
Scene 'Car_Embarking' ended
Scene 'Riding_Scene' ended
Scene 'Body_Discovery' playing (for 6 mins now)
(Scene monitoring now switched on. Type "scenes off" to switch it off again.)

>scope
1: myself (746273)
2: a body (747457)
3: a shelves (747489)
4: a books (747521)
5: a radio (747553)
6: a bottle of wine (747585)
7: a cell phone (746305)

>x val
I couldn't see any such thing.

* * *

>x fireplace
I couldn't see any such thing.

* * *

>w
I couldn't go that way.

>d
Greatroom
The greatroom was clearly where the occupants of the house were meant to spend the majority of their time. Tall dark rafters criscrossed the high ceiling, the exposed beams clearly meant to evoke a Swiss chalet.

A large set of sofas were arranged around a huge rug. A dark stain was conspicuous against the pattern of the fabric. Everything in the room faced a gray slate fireplace. A fire roared inside, fresh logs having been added not too long ago.

A small spiral staircase in the corner led up to a reading nook, which was open to the greatroom, separated by a wooden balustrade. Coming from somewhere up there I could hear "O Come, All Ye Faithful" warbling from what sounded like an old radio.

>w
Foyer
I walked into the spacious foyer, trying not to walk into the large lacquered screens in front of the door. The shiny black wood was decorated with an intricate picture in gold paint, depicting a Chinese court scene. It seemed at odds with the exterior of the house, but matched the rest of the decor; the interior was a mixture of Old World furniture and Asian influences.

A layer of snow had blown in through the open doorway, and was slowly melting into a puddle on the enormous Persian rug.

Three men stood on the rug, their coats and pant cuffs damp with snow. Val made introductions all around, as if nothing was wrong. Jan Svennson was a broad-shouldered man with pale blue eyes. He was casually brushing snow off a European performance fleece sweater. Either he liked ice climbing, or he wanted people to think he did. He had the handshake of a salesman and the grin of a frat boy.

Scott Gage, on the other hand, was tall and lanky, and didn't seem at all suited to the cold. He wore a pair of Japanese selvedge jeans with the cuffs turned up to make sure everyone knew it. I'd have guessed he'd picked them up somewhere in SoHo if it weren't for the sweater he was wearing, useless against real cold, as all Californian sweaters are. 

I studied their faces carefully. If one of them knew about Alan upstairs, they weren't letting on. The three men were overdressed for vacation, as rich men often are. But somehow, they were oddly mismatched. I doubted that they came here together.

* * *

>turn off radio
I switched the radio off.

* * *

>debug
That noun did not make sense in this context.

>scenes
Scene 'Entire Game' playing (for 14 mins now)
Scene 'Mountain_Driving' ended
Scene 'Car_Escape' ended
Scene 'Cliff_Climbing' ended
Scene 'Car_Embarking' ended
Scene 'Riding_Scene' ended
Scene 'Body_Discovery' playing (for 7 mins now)
(Scene monitoring now switched on. Type "scenes off" to switch it off again.)

>scope
1: myself (746273)
2: a body (747457)
3: a shelves (747489)
4: a books (747521)
5: a radio (747553)
6: a bottle of wine (747585)
7: a cell phone (746305)

* * *

>w
I couldn't go that way.

>look
Reading Nook
I climbed the stairs to the reading nook. Shelves lined the walls of the small room, and a couple of books had been knocked off them onto the floor. A pair of wingback armchairs faced each other with a coffee table in between.

A man sat in one, slightly paunchy and slightly grey, his eyes and mouth wide open. His glasses were askew. He was wearing a wool cardigan, stained on the front with a dark, almost black liquid. What looked like a large carving knife was sticking out of his chest, plunged in so far that only the handle was visible.

Val stood to my left, looking impassively at the body of Alan Bowden.

An antique wooden radio sat on the table.

I could also see a bottle of wine here.

>exits
down to Greatroom

* * *

>x body
I couldn't see any such thing.

>u
Reading Nook
I climbed the stairs to the reading nook. Shelves lined the walls of the small room, and a couple of books had been knocked off them onto the floor. A pair of wingback armchairs faced each other with a coffee table in between.

A man sat in one, slightly paunchy and slightly grey, his eyes and mouth wide open. His glasses were askew. He was wearing a wool cardigan, stained on the front with a dark, almost black liquid. What looked like a large carving knife was sticking out of his chest, plunged in so far that only the handle was visible.

Val stood to my left, looking impassively at the body of Alan Bowden.

An antique wooden radio sat on the table.

I could also see a bottle of wine here.

>x body
I could tell he didn't get out much. His skin was slightly pallid, and not just because he was dead.

* * *

>i
I was carrying:
  a bottle of wine
  a cell phone

>look
Reading Nook
I climbed the stairs to the reading nook. Shelves lined the walls of the small room, and a couple of books had been knocked off them onto the floor. A pair of wingback armchairs faced each other with a coffee table in between.

A man sat in one, slightly paunchy and slightly grey, his eyes and mouth wide open. His glasses were askew. He was wearing a wool cardigan, stained on the front with a dark, almost black liquid. What looked like a large carving knife was sticking out of his chest, plunged in so far that only the handle was visible.

Val stood to my left, looking impassively at the body of Alan Bowden.

An antique wooden radio sat on the table.

>x val
She wore a belted black overcoat with straight shoulders, which covered all of her except for the bottom of a long pencil skirt. She hadn't bothered taking her driving gloves off. I couldn't put my finger on it, but there was something stiffly formal and practised about the way she moved.

Her eyes rested on what was left of the professor, her expression unreadable.

* * *

>d
Greatroom
The greatroom was clearly where the occupants of the house were meant to spend the majority of their time. Tall dark rafters criscrossed the high ceiling, the exposed beams clearly meant to evoke a Swiss chalet.

A large set of sofas were arranged around a huge rug. A dark stain was conspicuous against the pattern of the fabric. Everything in the room faced a gray slate fireplace. A fire roared inside, fresh logs having been added not too long ago.

A small spiral staircase in the corner led up to a reading nook, which was open to the greatroom, separated by a wooden balustrade.

>w
Foyer
I walked into the spacious foyer, trying not to walk into the large lacquered screens in front of the door. The shiny black wood was decorated with an intricate picture in gold paint, depicting a Chinese court scene. It seemed at odds with the exterior of the house, but matched the rest of the decor; the interior was a mixture of Old World furniture and Asian influences.

A layer of snow had blown in through the open doorway, and was slowly melting into a puddle on the enormous Persian rug.

Three men stood on the rug, their coats and pant cuffs damp with snow. Val made introductions all around, as if nothing was wrong. Jan Svennson was a broad-shouldered man with pale blue eyes. He was casually brushing snow off a European performance fleece sweater. Either he liked ice climbing, or he wanted people to think he did. He had the handshake of a salesman and the grin of a frat boy.

Scott Gage, on the other hand, was tall and lanky, and didn't seem at all suited to the cold. He wore an expensive pair of Japanese selvedge jeans, cuffs turned up to make sure you knew it. I'd have guessed he'd picked them up somewhere in SoHo if it weren't for the sweater he was wearing, useless against real cold, as all Californian sweaters are. 

I studied their faces carefully. If one of them knew about Alan upstairs, they weren't letting on. The three men were overdressed for vacation, as rich men often are. But somehow, they were oddly mismatched. I doubted that they came here together.

I could also see Val here.

>w
Front Porch
Steps led up from the gravel driveway to the porch. Narrow unpainted wood planks extended the length of the house, along with windows that looked into rooms at the front of the house. Through them, I saw blinds, and a glint of something metallic.

>e
Foyer
I walked into the spacious foyer, trying not to walk into the large lacquered screens in front of the door. The shiny black wood was decorated with an intricate picture in gold paint, depicting a Chinese court scene. It seemed at odds with the exterior of the house, but matched the rest of the decor; the interior was a mixture of Old World furniture and Asian influences.

A layer of snow had blown in through the open doorway, and was slowly melting into a puddle on the enormous Persian rug.

Three men stood on the rug, their coats and pant cuffs damp with snow. Val made introductions all around, as if nothing was wrong. Jan Svennson was a broad-shouldered man with pale blue eyes. He was casually brushing snow off a European performance fleece sweater. Either he liked ice climbing, or he wanted people to think he did. He had the handshake of a salesman and the grin of a frat boy.

Scott Gage, on the other hand, was tall and lanky, and didn't seem at all suited to the cold. He wore an expensive pair of Japanese selvedge jeans, cuffs turned up to make sure you knew it. I'd have guessed he'd picked them up somewhere in SoHo if it weren't for the sweater he was wearing, useless against real cold, as all Californian sweaters are. 

I studied their faces carefully. If one of them knew about Alan upstairs, they weren't letting on. The three men were overdressed for vacation, as rich men often are. But somehow, they were oddly mismatched. I doubted that they came here together.

I could also see Val here.