Mercedes is a subject.
Ski chalet is a subject.
Dawn is a subject.

A Long Drink
An Interactive Mystery by Owen Parks
Release 7 / Serial number 150220 / Inform 7 build 6L38 (I6/v6.33 lib 6/12N) SD

Mountain Road
They say you shouldn't drive when you're angry. That was just one of a hundred pieces of good advice I was ignoring as I drove along the icy road to the chalet, my foot a little heavier on the gas than it needed to be.

I'd had a long, promising career in homicide ahead of me, or so I kept telling myself, and it was all down the drain now. I had planned on a senior detective's desk being in the cards for me, at least. Maybe even quitting and going into private investigations. Well, I guessed I could still do that.

Not six hours earlier, I'd turned in my badge and my gun and walked out, more or less the way I'd seen it in the movies. The captain was yelling his head off, couldn't figure out why a promising young detective like me would just up and quit. I honestly hoped he never did.

I kept on driving north.

(type "help" at any point for hints)

>test
>--> The following tests are available:
'test carescape'
'test firstconvo'
'test sunrise_lose'
'test discover'
'test body'
'test arrival'
'test myclues'
'test valinvest'
'test janinv'
'test master'
'test computer'
'test bedtime'
'test vdet'
'test cartrip'
'test gettinbopped'
'test me'

* * *

I beg your pardon?

>jlkjl;kj;lkj;lkj;lkj
That noun did not make sense in this context.

I beg your pardon?

* * *

>n/n/n/n/n/n/n/n/n/n/n
That noun did not make sense in this context.

* * *

>drive
Mountain Pass
I had the radio on tuned to some news station-- truth be told, I already missed the chatter of the dispatch as I was driving. The traffic report had little bearing on my current locale, but the weather gave me some concern: a snowstorm coming up off the Great Lakes. Spending the weekend with a small crowd I barely knew wasn't my idea of a good time. Being cooped up with them the entire time due to weather seemed like a recipe for an epidemic of cabin fever.

I continued north along the snowy road.

>drive
Hairpin Turn
If I'd finished that last thought a few seconds earlier, I might've noticed the caution sign for the sharp turn, barely visible through the snow. The car was going too fast, and the guardrail came out of nowhere.

>brake
I hit the brakes, but the car kept straight for the guardrail, slamming through, and going over.

The back end of the car lost traction and swung out wide, trying vainly to follow the front, just like one of those car commercials. Unfortunately, I was not a professional driver, nor was this a closed course, and the right side of the car went over the edge of the cliff, momentum then taking the rest of the car with it. In shock, my brain couldn't manage to tell my body to do more than grip the wheel uselessly as the car tumbled down the steep incline. I lost count of the rolls after three. The roof hit a tree, and I was jerked upward against the seat belt. Snow from the branches fell in a pile onto the passenger window from the impact. I heard a thud, snuffing out the brief glimpse of moonlight. Everything went black.

(press any key)
Upturned Car
I wasn't sure how long I'd been out. Taking stock of my situation, I was surprised to find myself more or less unhurt, save for a dull ache in my left wrist where I'd tried to brace against the door. I took a few deep breaths, and tried to focus.

The car was currently lying at the bottom of a cliff on its side. Above me, I could dimly see the light of the moon, mottled by the snow on the passenger side windows. The windshield in front of me showed nothing but evergreen forest, extending into the darkness.

I was still strapped in; the seat belt made sure I stayed put. At least one thing in this car still knew how to do its job right.

I beg your pardon?

>unbuckle self
I wrestled with the jammed seat belt for a moment, then managed to undo it, falling a few inches down against the driver door once the chest belt was free.

>kick windshield
Bracing my back against the sideways seat, I gave the windshield a couple of sharp kicks. I felt the seal start to give, and then it dislodged entirely from the frame, making an exit. It fell out onto the snow with a muffled crunch, and the bitter wind started to blow into the old car. I grabbed my bag and stepped out into the forest.

Bottom of Cliff
I stood on a ridge densely packed with trees some ways below the highway. My wrecked car sat a few feet away. The ridge extended as far as I could see to the north, going nowhere in particular. To the west I saw the steep incline the car had rolled down, and the path it'd cut through the snow and brush.

Turn Count: 1
FoundClues: 0

I beg your pardon?

>west
Sharp Bend
I walked on the snowy road about a hundred feet from the hairpin turn where my car had gone over; I could see the tire tracks and broken guardrail to the east.

The second I turned my head to look down the lane, I saw a pair of headlights approach. A black Mercedes pulled up and came to a stop just in front of me. The passenger door opened, and I saw Val looking out at me.

"Get in," she said.

Turn Count: 2
FoundClues: 0

>get in
I got into the Mercedes.

Sedan
The inside of the Mercedes was yards of brushed metal and hand-stitched leather. It still smelled new. Having run out of things to talk about, I had nothing to do but wait for us to arrive.

Val drove the car, her eyes looking miles beyond the road, the mountains, and the horizon.

Turn Count: 3
FoundClues: 0

>talk to val
I said hello to Val.

Turn Count: 4
FoundClues: 0
I could have asked ask about her car, ask about the chalet or ask about sunrise.

>ask about her car
"Nice ride," I said.

"You should have called," Val replied, ignoring my comment.

Turn Count: 5
FoundClues: 0
I could have asked ask about the chalet or ask about sunrise.

>ask about the chalet
Where are we going?

TODO.

Turn Count: 6
FoundClues: 0
I could have asked ask about sunrise.

>ask about sunrise
"Sun goes up at 7:03 today. Always check the time before you leave for the night," she said.

I looked out the window, trying not to feel like a kid being lectured by his mom.

Turn Count: 7
FoundClues: 0

>wait
Driveway
We stood at the end of a long gravel drive, staring up at a large house with a dark red wood exterior. Steps to the east led to a porch that spanned the facade of the place, wrapping around to a deck in the back that presumably had a great view of the lake and the countryside. It was more ski lodge than cabin, and looked like it could comfortably shelter an entire biathlon team if it had to.

Val got out of the car and took her bag out of the trunk.

"Come on, I'll introduce you to Alan," she said, walking up the drive.

Turn Count: 8
FoundClues: 0

>east
Front Porch
Steps led up from the gravel driveway to the porch. Narrow unpainted wood planks extended the length of the house, along with windows that looked into rooms at the front of the house. Through them, I saw blinds, and a glint of something metallic, like a shutter.

The front door stood open.

There was something about the door that looked like a B&E job.

Turn Count: 9
FoundClues: 0

>examine door
A large wooden door, painted white as a preacher's picket fence. It didn't have a window or peephole. Something seemed odd about the lock, like it had been damaged. There was splintered wood on the side of the doorframe where someone had apparently forced the door open.

Turn Count: 10
FoundClues: 0

>examine lock
I could see obvious scratch marks at the deadbolt that could've been left by an intruder using a lockpick. Judging by the deep gouges in the doorframe, the attempt hadn't been successful.

Turn Count: 11
FoundClues: 1

>east
Foyer
I walked into the spacious foyer, trying not to walk into the large lacquered wood screens in front of the door. The shiny black surfaces were decorated with an intricate picture in gold paint, depicting a Chinese court scene. It seemed at odds with the exterior of the house, but matched the rest of the decor; the interior was a mixture of Old World furniture and Asian influences.

A layer of snow had blown in through the open doorway, and was slowly melting into a puddle on the enormous Persian rug. 

The front door stood open.

I could also see Val_HouseTODO here.

Turn Count: 12
FoundClues: 1

>east
Greatroom
The greatroom was clearly where the occupants of the house were meant to spend the majority of their time. Tall, dark wooden rafters criscrossed the high ceiling, the exposed beams clearly meant to evoke a Swiss chalet.

A large set of sofas were arranged around a huge rug. A dark stain was conspicuous on the armrest, standing out on the white fabric. Everything in the room faced a gray slate fireplace. A fire roared inside, fresh logs having been added not too long ago.

A small spiral staircase in the corner led up to a reading nook, which was open to the greatroom, separated by a wooden balustrade. Coming from somewhere up there I heard "Hark, The Herald Angels Sing" warbling from what sounded like an old radio.

Turn Count: 13
FoundClues: 1

>examine stain
An oblong dark red spot about the size of a pear stood out from the beige couch. From the color, it looked like wine. As I looked at it, I realized something on the floor was reflecting firelight back at me.

Turn Count: 14
FoundClues: 2

>look
Greatroom
The greatroom was clearly where the occupants of the house were meant to spend the majority of their time. Tall, dark wooden rafters criscrossed the high ceiling, the exposed beams clearly meant to evoke a Swiss chalet.

A large set of sofas were arranged around a huge rug. A dark wine stain was conspicuous on the armrest, standing out on the white fabric. Everything in the room faced a gray slate fireplace. A fire roared inside, fresh logs having been added not too long ago.

A small spiral staircase in the corner led up to a reading nook, which was open to the greatroom, separated by a wooden balustrade. Coming from somewhere up there I heard "We Three Kings" warbling from what sounded like an old radio.

I could see a glass shard here.

Turn Count: 15
FoundClues: 2

>examine shard
A broken shard of glass. The ruined facets of vintage crystal reflected light like a cheap engagement ring.

I crouched down for a closer look and realized it had come from a shattered wineglass,  the pieces obscured by the sofa.

Turn Count: 16
FoundClues: 2

>examine broken wineglass
The curves of the wineglass were jagged edges now, a heap of shattered crystal under the sofa. It must've fallen from quite a height.

Turn Count: 17
FoundClues: 3

>take all
broken wineglass: I had enough of a mess on my hands without taking this one with me, but kept it anyway. It told an interesting story.
glass shard: Taken.

Turn Count: 18
FoundClues: 3

>up
Reading Nook
I climbed the stairs to the reading nook. Shelves lined the walls of the small room, and a couple of books had been knocked off them onto the floor. A pair of wingback armchairs faced each other with a coffee table in between. A small pool of red liquid lay underneath the table.

A man sat in one, slightly paunchy and slightly grey, his eyes and mouth wide open. His glasses were askew. He was wearing a navy blue cardigan, stained all over the front with a dark, almost black liquid. What looked like a small knife was sticking out of his neck, plunged in so far that only the handle was visible.

An antique wooden radio sat on the table, playing Christmas carols.

I could also see a bottle of wine and a wineglass here.

Turn Count: 19
FoundClues: 3

>examine bottle
A Bordeaux from back in 2001, uncorked and almost empty. Expensive bottle to be drinking alone.

Turn Count: 20
FoundClues: 4

>examine wineglass
(the broken wineglass)
The curves of the wineglass were jagged edges now, a heap of shattered crystal under the sofa. It must've fallen from quite a height.

Turn Count: 21
FoundClues: 4

>examine body
He looked like he was fifty, but something about his well-preserved look told me that he was probably sixty. It wasn't that he was in good shape-- I doubted he'd seen much real exercise since he was in high school, and maybe not even then. He struck me as a debate team sort of guy.  I could tell he didn't get out much. His fingers were broad, but smooth. His hands had no calluses and no rings, but he wore a Rolex watch. It wasn't fake, and had cost probably three times what my car was worth before I'd driven it off a cliff a few hours ago.

Val came up the stairs, freezing the second she saw the body. Her eyes narrowed, and I could tell her mind was racing, the first time I'd seen anything but placid boredom on her face. Half of me was relieved to know that there was something in this world that could perturb her. The other half was unnerved by it. She looked away and hitched the poker face back on pretty quick.

Val nodded at the poor stiff and said, "Meet Professor Alan Bowden, our host this weekend."

Turn Count: 22
FoundClues: 4

I beg your pardon?

>examine knife
It looked like a silver letter opener with an ivory handle. A monogram on the end read "AHB". It didn't look that long or that sharp, but someone had made a pretty clean business of stabbing Bowden with it. Or maybe they'd just gotten lucky. It happens like that sometimes.

Turn Count: 23
FoundClues: 5

>examine pool
A small pool of red wine had fallen on the rug underneath the table, bleeding out onto the wood floor.

Turn Count: 24
FoundClues: 6

>down
Greatroom
The greatroom was clearly where the occupants of the house were meant to spend the majority of their time. Tall, dark wooden rafters criscrossed the high ceiling, the exposed beams clearly meant to evoke a Swiss chalet.

A large set of sofas were arranged around a huge rug. A dark wine stain was conspicuous on the armrest, standing out on the white fabric. Everything in the room faced a gray slate fireplace. 

A small spiral staircase in the corner led up to a reading nook, which was open to the greatroom, separated by a wooden balustrade. Coming from somewhere up there I heard "God Rest Ye Merry, Gentlemen" warbling from what sounded like an old radio.

Turn Count: 25
FoundClues: 6

>up
Reading Nook
I climbed the stairs to the reading nook. Shelves lined the walls of the small room, and a couple of books had been knocked off them onto the floor. A pair of wingback armchairs faced each other with a coffee table in between. A small pool of red liquid lay underneath the table.

A man sat in one, slightly paunchy and slightly grey, his eyes and mouth wide open. His glasses were askew. He was wearing a navy blue cardigan, stained all over the front with a dark, almost black liquid. What looked like a small knife was sticking out of his neck, plunged in so far that only the handle was visible.

Val stood to my left, looking impassively at the body of Alan Bowden.

An antique wooden radio sat on the table, playing Christmas carols.

I could also see a bottle of wine and a wineglass here.

Turn Count: 26
FoundClues: 6

>down
Greatroom
The greatroom was clearly where the occupants of the house were meant to spend the majority of their time. Tall, dark wooden rafters criscrossed the high ceiling, the exposed beams clearly meant to evoke a Swiss chalet.

A large set of sofas were arranged around a huge rug. A dark wine stain was conspicuous on the armrest, standing out on the white fabric. Everything in the room faced a gray slate fireplace. 

A small spiral staircase in the corner led up to a reading nook, which was open to the greatroom, separated by a wooden balustrade. Coming from somewhere up there I heard "O Come, All Ye Faithful" warbling from what sounded like an old radio.

Turn Count: 27
FoundClues: 6

>up
Reading Nook
I climbed the stairs to the reading nook. Shelves lined the walls of the small room, and a couple of books had been knocked off them onto the floor. A pair of wingback armchairs faced each other with a coffee table in between. A small pool of red liquid lay underneath the table.

A man sat in one, slightly paunchy and slightly grey, his eyes and mouth wide open. His glasses were askew. He was wearing a navy blue cardigan, stained all over the front with a dark, almost black liquid. What looked like a small knife was sticking out of his neck, plunged in so far that only the handle was visible.

Val stood to my left, looking impassively at the body of Alan Bowden.

An antique wooden radio sat on the table, playing Christmas carols.

I could also see a bottle of wine and a wineglass here.

Turn Count: 28
FoundClues: 6

>down
Greatroom
The greatroom was clearly where the occupants of the house were meant to spend the majority of their time. Tall, dark wooden rafters criscrossed the high ceiling, the exposed beams clearly meant to evoke a Swiss chalet.

A large set of sofas were arranged around a huge rug. A dark wine stain was conspicuous on the armrest, standing out on the white fabric. Everything in the room faced a gray slate fireplace. 

A small spiral staircase in the corner led up to a reading nook, which was open to the greatroom, separated by a wooden balustrade. Coming from somewhere up there I heard "God Rest Ye Merry, Gentlemen" warbling from what sounded like an old radio.

Turn Count: 29
FoundClues: 6

>up
Reading Nook
I climbed the stairs to the reading nook. Shelves lined the walls of the small room, and a couple of books had been knocked off them onto the floor. A pair of wingback armchairs faced each other with a coffee table in between. A small pool of red liquid lay underneath the table.

A man sat in one, slightly paunchy and slightly grey, his eyes and mouth wide open. His glasses were askew. He was wearing a navy blue cardigan, stained all over the front with a dark, almost black liquid. What looked like a small knife was sticking out of his neck, plunged in so far that only the handle was visible.

Val stood to my left, looking impassively at the body of Alan Bowden.

An antique wooden radio sat on the table, playing Christmas carols.

I could also see a bottle of wine and a wineglass here.

Turn Count: 30
FoundClues: 6

>down
Greatroom
The greatroom was clearly where the occupants of the house were meant to spend the majority of their time. Tall, dark wooden rafters criscrossed the high ceiling, the exposed beams clearly meant to evoke a Swiss chalet.

A large set of sofas were arranged around a huge rug. A dark wine stain was conspicuous on the armrest, standing out on the white fabric. Everything in the room faced a gray slate fireplace. 

A small spiral staircase in the corner led up to a reading nook, which was open to the greatroom, separated by a wooden balustrade. Coming from somewhere up there I heard "We Three Kings" warbling from what sounded like an old radio.

Turn Count: 31
FoundClues: 6

>up
Reading Nook
I climbed the stairs to the reading nook. Shelves lined the walls of the small room, and a couple of books had been knocked off them onto the floor. A pair of wingback armchairs faced each other with a coffee table in between. A small pool of red liquid lay underneath the table.

A man sat in one, slightly paunchy and slightly grey, his eyes and mouth wide open. His glasses were askew. He was wearing a navy blue cardigan, stained all over the front with a dark, almost black liquid. What looked like a small knife was sticking out of his neck, plunged in so far that only the handle was visible.

Val stood to my left, looking impassively at the body of Alan Bowden.

An antique wooden radio sat on the table, playing Christmas carols.

I could also see a bottle of wine and a wineglass here.

Turn Count: 32
FoundClues: 6
I heard the front door open, and the sound of voices from the foyer. It closed a minute later.

Val and I glanced at each other across the dead man, and she left back down the stairs.

I beg your pardon?

>down
Greatroom
The greatroom was clearly where the occupants of the house were meant to spend the majority of their time. Tall, dark wooden rafters criscrossed the high ceiling, the exposed beams clearly meant to evoke a Swiss chalet.

A large set of sofas were arranged around a huge rug. A dark wine stain was conspicuous on the armrest, standing out on the white fabric. Everything in the room faced a gray slate fireplace. 

A small spiral staircase in the corner led up to a reading nook, which was open to the greatroom, separated by a wooden balustrade. Coming from somewhere up there I heard "God Rest Ye Merry, Gentlemen" warbling from what sounded like an old radio.

Turn Count: 33
FoundClues: 6

>west
Foyer
I walked into the spacious foyer, trying not to walk into the large lacquered wood screens in front of the door. The shiny black surfaces were decorated with an intricate picture in gold paint, depicting a Chinese court scene. It seemed at odds with the exterior of the house, but matched the rest of the decor; the interior was a mixture of Old World furniture and Asian influences. 

Three men stood on the rug, their coats and pant cuffs damp with snow. Val made introductions all around, as if nothing was wrong. 

I studied their faces carefully. If one of them knew about Alan upstairs, they weren't letting on. The three men were overdressed for vacation, as rich men often are. But somehow, they were oddly mismatched. I doubted that they came here together.

I could also see Nathan, Scott and Jan here.

Turn Count: 34
FoundClues: 6

>examine Nathan
The sideswept brown locks and pencil mustache were meant to look youthful and sporty, like he'd just stopped playing cricket for teatime. The lines on the face and brow made him look more Vincent Price than Errol Flynn, though. I could tell by the way he stood that he didn't have a care in the world, or at least I wasn't one of them. His half-lidded stare gave him an air of casual arrogance, like he was perpetually waiting for the valet to bring his car around.

Turn Count: 35
FoundClues: 6

>examine Scott
Scott Gage, on the other hand, was tall and lanky, and didn't seem at all suited to the cold. He wore a pair of Japanese selvedge jeans with the cuffs turned up to make sure everyone knew it. I'd have guessed he'd picked them up somewhere in SoHo if it weren't for the sweater he was wearing, useless against real cold, as all Californian sweaters are.

Turn Count: 36
FoundClues: 6

>examine Jan
Jan Svennson was a broad-shouldered man with pale blue eyes. He was casually brushing snow off a European performance fleece sweater. Either he liked ice climbing, or he wanted people to think he did. He had the handshake of a salesman and the grin of a frat boy.

Turn Count: 37
FoundClues: 6

>east
Val waited a minute for the conversations the three were having to die down.
(Press a key)She folded her arms across her chest and took a deep breath quiet enough that only I heard it.

"Gentlemen, we have a problem. Alan's dead. We found him upstairs, stabbed."

A stunned silence followed. When it was clear no one was going to break it, she went on. "I'm going to call it in to the New York Magistrate's and find out who isn't on vacation that they can send over." She lifted a hand, exposing her pale wrist enough to read the face of her watch. "It's going to be at least six hours before they can send someone, and they'll have to make it through what's left of the winter storm. Until we can figure out exactly what happened and who's responsible, I suggest we all stay in our rooms. My associate here has some experience with police investigation, he can do the basics until the officials show up."

Nathaniel seemed to bristle at this. "Hang on a minute, wait in our rooms? Am I to take it you're presuming us suspects? How do I know you and your friend didn't just kill Alan?"

Val shrugged and pointed at me. "It happens that my friend here is the only one of us with a solid alibi, unless I'm mistaken."

The lack of a response indicated that she wasn't, which bothered me a little. The three picked up their bags and trundled down the hall, varying degrees of insulted, Jan called back in a raised voice. "You're making a big mistake. Don't you remember what happened at Lake Geneva in 1986? I think there's someone out there who got Alan, and now we're sitting ducks."

He said it with false bravado, and I shouldn't have let the idea take root in my mind, but it did.

Turn Count: 38
FoundClues: 6

I beg your pardon?

>talk to val
I said hello to Val_HouseTODO.

Turn Count: 39
FoundClues: 6
I could have asked ask about Alan, ask about the murder, ask about Nathaniel or ask what was in it for me.

I beg your pardon?

>ask about Alan
"How well did you know Alan?"

Whisper quiet, shutters slid down on the inside of every window in the house. They looked like opaque fabric window shades, but the heavy sound of the seal told me the core was probably metal. The moonlight went out as suddenly as if someone had thrown a curtain over it.

(press any key)
"I knew him for probably ten years, we were only close for a handful of those. He wasn't perfect, but I knew him well enough that I feel like he deserved better than he got."

Turn Count: 40
FoundClues: 6
I could have asked ask about the murder, ask about Nathaniel or ask what was in it for me.

>ask about the murder
Val leaned in close until her face was inches from mine, and lowered her voice, even though no one was around. "Listen, kid. Here's how it's going down. We have a few hours before what passes for the law for our kind shows up and starts stomping its flat feet around. They don't much care if the wrong one of us takes the rap, or if no one does. Alan's nobody to the Circle, I doubt they'd care if this case went stone cold. But he used to be a friend of mine, and this is something I want to do for him."

I didn't say anything.

Turn Count: 41
FoundClues: 6
I could have asked ask about Nathaniel or ask what was in it for me.

>ask about nathaniel
"This Nathaniel Wyndham, is he old money?" I asked.

"I guess. He made a sizeable fortune selling boots to the Allies during World War I, a real war profiteer. He used it to buy that ridiculous title, a couple of country estates, and even restored an old manor house. But a little time running with the Circle crowd will tell you that "old money" is a relative term."

Turn Count: 42
FoundClues: 6
I could have asked ask what was in it for me.

>ask what was in it for me
"Seems like a pretty long way to stick my neck out for you. What's in it for me, exactly?"

She gave me a sharp look. I could tell it got a lot of use, it was just as practiced as everything else about her. Here was a woman who wasn't afraid to throw her weight around, and made it a bad habit to make her do it.

"Think of me as your first client as a private dick. I'm asking you to make this one on the house. You owe me, remember?"

She had me there. I didn't know if this was the kind of thing I could pay back, but I didn't like owing that kind of debt.

Turn Count: 43
FoundClues: 6

>east
Greatroom
The greatroom was clearly where the occupants of the house were meant to spend the majority of their time. Tall, dark wooden rafters criscrossed the high ceiling, the exposed beams clearly meant to evoke a Swiss chalet.

A large set of sofas were arranged around a huge rug. A dark wine stain was conspicuous on the armrest, standing out on the white fabric. Everything in the room faced a gray slate fireplace. A fire roared inside, fresh logs having been added not too long ago.

A small spiral staircase in the corner led up to a reading nook, which was open to the greatroom, separated by a wooden balustrade. Coming from somewhere up there I heard "God Rest Ye Merry, Gentlemen" warbling from what sounded like an old radio.

Turn Count: 44
FoundClues: 6

>east
Downstairs Hallway
A long narrow corridor connected the entrance of the house with the bedrooms. Lights were recessed into the ceiling overhead, shining down onto the polished wood floor. Maybe some people liked this sterile modern crap, but it made the place look like an art gallery, as far as I was concerned. A couple of paintings even adorned the walls, so maybe that was the idea, and I was just uncultured.

Turn Count: 45
FoundClues: 6

>north
Office
Of all the rooms I'd seen in the house, this one looked the most lived in. It had the musty smell of old books mixed with stale coffee coming from several cups on the desk.

I could see a computer here.

Turn Count: 46
FoundClues: 6

>examine cups
Mugs of coffee, stone cold. I could see brown stains on the sides of the half-empty cups where the liquid had evaporated. They'd been here a few days, but that didn't indicate a time of death. The kind of man who leaves more than two coffee cups sitting on a desk isn't in a hurry to clean up after himself.

Turn Count: 47
FoundClues: 6

>examine books
I couldn't see any such thing.

>open desk
I opened the desk, revealing a bank statement.

Turn Count: 48
FoundClues: 6

>examine papers
I thumbed through the pile on the desk, finding term papers and dissertations, collections of academic journals. Underneath most of it was something that caught my eye, a document with dollar signs on it and more zeroes than I'm used to seeing on paper.

Turn Count: 49
FoundClues: 6

>examine bank statement
I saw nothing special about the bank statement.

Turn Count: 50
FoundClues: 7

>take all
bank statement: Taken.

Turn Count: 51
FoundClues: 7

>south
Downstairs Hallway
A long narrow corridor connected the entrance of the house with the bedrooms. Lights were recessed into the ceiling overhead, shining down onto the polished wood floor. Maybe some people liked this sterile modern crap, but it made the place look like an art gallery, as far as I was concerned. A couple of paintings even adorned the walls, so maybe that was the idea, and I was just uncultured.

Turn Count: 52
FoundClues: 7

>up
Upstairs Hallway
Turn Count: 53
FoundClues: 7

>north
North Hallway
Turn Count: 54
FoundClues: 7

>west
(first opening bedroom door)
I reached the room where Val was staying, and supposed it was where I was staying, too. My tired fingers closed tightly around the doorknob like a pitcher throwing his last solid knuckleball in the ninth inning. 

I paused for a moment, mentally tallying what I'd put together about what had happened. I figured I ought to make sure I'd found enough clues for the day before I turned in.

Turn Count: 55
FoundClues: 7

>west
(first opening bedroom door)

Bedroom

I could see a bottle of bourbon here.

Turn Count: 56
FoundClues: 7

I beg your pardon?

>drink bourbon
I poured out a measure into one of the glasses on the nightstand and drank it slowly, letting it linger on my tongue.

I thought about the idea that someone was just outside the window, peering in, waiting the way a hunter sits in a blind, waiting for ducks. I thought about the three men I'd just met, and how I liked none of them. I thought about the man I'd seen in the chair with his eyes wide open, who didn't seem to mind that I was drinking his bourbon, since he didn't mind much of anything anymore.

Turn Count: 57
FoundClues: 7

>drink bourbon
I went back to the bottle and poured again, more generous this time. I listened to the sound of something between snow and frozen rain pattering against the window. I listened to Val's steady breathing. She was either asleep, or thinking just as hard as I was. I stared at her back a long time, trying to decide if I wanted to talk to her.

Turn Count: 58
FoundClues: 7

>drink bourbon
I changed into my pajamas and got into bed under the covers. I kept a reasonable distance between the two of us on the bed, though she didn't seem the type to get prudish about that kind of thing. I lay there thinking for a long time, trying to put together everything I'd heard into a picture that made sense. After five minutes that took two hours, I fell asleep, and dreamt of nothing.

(press any key)
I awoke to an empty room, bathed in the silver moonlight. She hadn't made a sound when she'd left. It took a second for me to realize that the shutters had gone back up. Through the window, I could see that lights were starting to come on in the distant houses dotted across the mountainside.

I wasn't sure how long I'd slept, but it must have been about eight o'clock in the evening.

Turn Count: 59
FoundClues: 7

>talk to val
I wasn't talking to anyone right then.

>ask how long
I wasn't talking to anyone.

>sleep
I wasn't feeling especially drowsy.

Turn Count: 60
FoundClues: 7

I beg your pardon?

>east
North Hallway
I could see Adrian here.

Turn Count: 61
FoundClues: 7

>talk to Adrian
He stood well over six feet with a build that belonged on the inside of a steel cage. The designer charcoal suit he wore hadn't quite been successfully altered to his wide frame. A deep purple tie sat at his neck in a fat knot Donald Trump would have approved of. The dark hair atop his head was neatly parted at the side, and slicked back almost flat to his head. His eyes were gray, and there was something baleful deep in them, peering out.  His size and heavy brow made him look like a gorilla in Prada.

He introduced himself as "Adrian Castillo, Deputy to the Warden of the Peace, appointed to serve at the pleasure of the Honorable Countess of Westchester." I didn't know what most of that meant, but I knew his suit was a little too nice for a cop entirely on the level. I wondered if that all fit on his business card.

I said hello to Adrian.

Turn Count: 62
FoundClues: 7
I could have asked ask about questioning me or ask how he knew my name.

>ask about questioning me
"So am I a suspect here?"

"Nah. I'm just going through the formalities, just in case. I just wanted to talk to everyone who had a personal connection with the guy. That leaves you off the hook. Not to mention the the alibi you left, according to your girlfriend.
"Oh?"
"Yeah, that twisted junk heap at the bottom of a cliff. They'll have a heck of a time towing that up. Anyway, if you were wandering out there a couple of hours ago, then there's no way you could get here at the time of death. But hey, if the lady turns out to have done it, maybe I can pin you with accessory to murder if you smile at me real nice."

Turn Count: 63
FoundClues: 7
I could have asked ask about questioning val or ask how he knew my name.

>ask about questioning val
"I'm going to need you to come with me downstairs. I've got to ask Ms. Carter a few questions, and she asked you be present." That confused me a bit. I wasn't entirely certain what Val and I were to each other, but I sure as hell wasn't her lawyer.

Turn Count: 64
FoundClues: 7
I could have asked ask about anyone outside.

>ask how he knew my name
"Did Val tell you about me?"

"Nah, you I remember. I couldn't tell you much about these old timers, but your paperwork went through the office just the other day. We like to keep tabs on the newcomers. Your file said you used to work in homicide, huh." It wasn't a question.

Turn Count: 65
FoundClues: 7
I could have asked ask about my file or ask about anyone outside.

>ask about my file
"I've only been one of you people for 48 hours, and I already have a file?"

"You've had a file for three weeks now." I didn't like that. I didn't like it so much I could hardly think of a cute comeback to make. He seemed to enjoy lording over me the fact that he knew something that I didn't. It was probably a feeling he didn't get to enjoy very often.

Turn Count: 66
FoundClues: 7

>ask about anyone outside
"See anyone on your way in? A couple of guests seemed pretty spooked about the idea that the killer would come back, something about Lake Geneva." I kept my voice smooth and casual, like I wasn't at all nervous about the idea of being game in somebody else's pheasant hunt.

"Nope, all quiet out there." Something in my face must've shown my silent vote of no confidence, since he tried to follow it up. "Listen, punk. I've been in this business twice as long as you've been alive. If I don't see nobody out there, there ain't nobody." I didn't tell him that that meant exactly jack and shit in my book. One look at him told me he didn't have an eye for detail. There's people on every force who can't think their way out of a wet paper bag, and I'd have bet my weight in cake donuts that Detective Castillo here was one of them.

Turn Count: 67
FoundClues: 7

>south
TODO

Office
Of all the rooms I'd seen in the house, this one looked the most lived in. It had the musty smell of old books mixed with stale coffee coming from several cups on the desk.

I could see a computer here.

TODO
Turn Count: 68
FoundClues: 7

>talk to val
I said hello to Val.

Turn Count: 69
FoundClues: 7
He could have ask about herself or ask about her family.

>ask about herself
Castillo took an official sort of bearing, or the nearest he could manage to one. "Please state your name for the record."

"Valentine Elizabeth Carter."

"Any aliases or other names you've used before?"

"Elizabeth Deverell, but not recently."

Turn Count: 70
FoundClues: 7
He could have ask about her family.

>ask about her family
"Any family?"
"None living."
"Married?"
"Widowed."

Turn Count: 71
FoundClues: 7
He could have ask about her husband.

>ask about her husband
"And what was your late husband's name?"

"Emil. But seeing as he's been dead fifty years, how about we leave him out of this?"

Castillo didn't pursue it any further after hearing her tone. He probably could have, but didn't want to push things into open antagonism without a reason. I wouldn't have, in his place."

Turn Count: 72
FoundClues: 7
Val put her cigarette out and got up. Her expression was stony, the businesslike demeanor she'd started with was gone now. Castillo got up, too, but stopped himself from saying anything. He didn't strike me as the sharpest tool in the shed, but he'd clearly learned where the line was. Staying in the good graces of his employer meant staying within the level of harassment his job warranted, and not ruffling the feathers of anyone too important in the Circle.

"You'll let me know if there's anything else I can do to help, Deputy?" she said icily. She hadn't bothered looking at him as she said it. She gave me a look full of meaning and left the room in the direction of the foyer, closing the door behind her. Castillo suddenly seemed very small standing behind the desk. He must have felt it, too, because he got up and left without another word to me.

>south
Downstairs Hallway
A long narrow corridor connected the entrance of the house with the bedrooms. Lights were recessed into the ceiling overhead, shining down onto the polished wood floor. Maybe some people liked this sterile modern crap, but it made the place look like an art gallery, as far as I was concerned. A couple of paintings even adorned the walls, so maybe that was the idea, and I was just uncultured.

I could see Adrian here.

Turn Count: 73
FoundClues: 7

>west
Greatroom
The greatroom was clearly where the occupants of the house were meant to spend the majority of their time. Tall, dark wooden rafters criscrossed the high ceiling, the exposed beams clearly meant to evoke a Swiss chalet.

A large set of sofas were arranged around a huge rug. A dark wine stain was conspicuous on the armrest, standing out on the white fabric. Everything in the room faced a gray slate fireplace. 

A small spiral staircase in the corner led up to a reading nook, which was open to the greatroom, separated by a wooden balustrade. Coming from somewhere up there I heard "Hark, The Herald Angels Sing" warbling from what sounded like an old radio.

Turn Count: 74
FoundClues: 7

>west
Foyer
I walked into the spacious foyer, trying not to walk into the large lacquered wood screens in front of the door. The shiny black surfaces were decorated with an intricate picture in gold paint, depicting a Chinese court scene. It seemed at odds with the exterior of the house, but matched the rest of the decor; the interior was a mixture of Old World furniture and Asian influences. 

I could also see Val_SecondInv_TODO here.

Turn Count: 75
FoundClues: 7

>talk to val
I said hello to Val_SecondInv_TODO.

Turn Count: 76
FoundClues: 7
I could have ask about my file or ask what she wanted to see me about.

>ask about my file
I put on my tough detective voice to try and take some of the surprise out of it. I had an image to maintain. "I heard about my file from Castillo. You've been stalking me for weeks now?"
"I wouldn't put it like that."
"How would you put it then?"
"I got the go ahead for a Patron application I put in a while back. That sort of opportunity doesn't come every day, so I scouted for a recruit. And then I made you an offer."

Turn Count: 77
FoundClues: 7
I could have ask about our first meeting or ask what she wanted to see me about.

>ask what she wanted to see me about
She lowered her voiceTODO

Turn Count: 78
FoundClues: 7
I could have ask about our first meeting.

>ask about our first meeting
"So the first time we met, that wasn't a coincidence, was it?"
"Would you have chosen differently if you'd known?"
"No."
"Then what the hell are you sore about?" She was starting to sound impatient again.

Turn Count: 79
FoundClues: 7

>west
(first opening the front door)

Front Porch
Steps led up from the gravel driveway to the porch. Narrow unpainted wood planks extended the length of the house, along with windows that looked into rooms at the front of the house. Through them, I saw blinds, and a glint of something metallic, like a shutter.

The front door stood open.

Turn Count: 80
FoundClues: 7

>west
Driveway
We stood at the end of a long gravel drive, staring up at a large house with a dark red wood exterior. Steps to the east led to a porch that spanned the facade of the place, wrapping around to a deck in the back that presumably had a great view of the lake and the countryside. It was more ski lodge than cabin, and looked like it could comfortably shelter an entire biathlon team if it had to.

Val's Mercedes was parked to one side of the driveway.

Turn Count: 81
FoundClues: 7

>get in
Sharp Bend
I walked on the snowy road about a hundred feet from the hairpin turn where my car had gone over; I could see the tire tracks and broken guardrail to the east.

A Mercedes is quietly idling here, V8 purring.

I could also see Val_SecondInv_TODO here.

Turn Count: 82
FoundClues: 7

>east
Bottom of Cliff
I stood on a ridge densely packed with trees some ways below the highway. My wrecked car sat a few feet away. The ridge extended as far as I could see to the north, going nowhere in particular. To the west I saw the steep incline the car had rolled down, and the path it'd cut through the snow and brush.

My Toyota Corolla in a fetching "Regatta Blue" that must have looked appealing under bright dealership lights when it was brand new back in 1990. I wouldn't know. It now sat on its side like a beached whale, exactly where I'd left it. The key was still in the ignition.

Turn Count: 83
FoundClues: 7

>turn on car
I leaned into the cabin through the hole left by the windshield and turned the key. The headlights flicked on, and the dashboard lit up. I heard the radio bleat into the empty forest, muffled by the dull roar of air pouring out of the A/C vents. The engine turned over but didn't start. The inertia switch had cut off fuel to the engine when the car rolled down the hill. I didn't really mind, I hadn't planned on driving it out of here.

Turn Count: 84
FoundClues: 7

>examine dashboard
I scanned the panel, and saw a red indicator I'd never seen lit before. The brake light.

Turn Count: 85
FoundClues: 7

>examine brakes
I put a hand behind the wheel and the suspension arm and felt along the metal tube of the brake line, nearly slicing my finger on a thin slit. It wasn't a bit of rust or metal fatigue, the cut was too clean. It might have been made by a dremel or a wire cutter. Cutting brake lines straight through would stop the front brakes from working. But a leak like this could take hours to affect performance. Whatever my state of mind or driving had been on that turn, this wasn't an accident.

The fact that I was able to see all of this without a flashlight barely registered.

Turn Count: 86
FoundClues: 8

>west
Sharp Bend
I walked on the snowy road about a hundred feet from the hairpin turn where my car had gone over; I could see the tire tracks and broken guardrail to the east.

A Mercedes is quietly idling here, V8 purring.

I could also see Val_SecondInv_TODO here.

Turn Count: 87
FoundClues: 8

>get in car
Driveway
We stood at the end of a long gravel drive, staring up at a large house with a dark red wood exterior. Steps to the east led to a porch that spanned the facade of the place, wrapping around to a deck in the back that presumably had a great view of the lake and the countryside. It was more ski lodge than cabin, and looked like it could comfortably shelter an entire biathlon team if it had to.

Val's Mercedes was parked to one side of the driveway.

I could also see Val_SecondInv_TODO here.

Turn Count: 88
FoundClues: 8

>east
Front Porch
Steps led up from the gravel driveway to the porch. Narrow unpainted wood planks extended the length of the house, along with windows that looked into rooms at the front of the house. Through them, I saw blinds, and a glint of something metallic, like a shutter.

The front door stood open.

Turn Count: 89
FoundClues: 8

>east
I walked into the house, taking care to close the door behind me.

Foyer
I walked into the spacious foyer, trying not to walk into the large lacquered wood screens in front of the door. The shiny black surfaces were decorated with an intricate picture in gold paint, depicting a Chinese court scene. It seemed at odds with the exterior of the house, but matched the rest of the decor; the interior was a mixture of Old World furniture and Asian influences. 

Foyer
I walked into the spacious foyer, trying not to walk into the large lacquered wood screens in front of the door. The shiny black surfaces were decorated with an intricate picture in gold paint, depicting a Chinese court scene. It seemed at odds with the exterior of the house, but matched the rest of the decor; the interior was a mixture of Old World furniture and Asian influences. 

I hadn't realized it until I saw an edge of light blue on the horizon, but we'd cut things pretty close again. A quiet whirring of the closing shutters and a click of the lock was the only indication that the sun was about to rise. The foyer went artificially dark again, except for the light of the brass chandelier.

Turn Count: 90
FoundClues: 8

>east
Greatroom
The greatroom was clearly where the occupants of the house were meant to spend the majority of their time. Tall, dark wooden rafters criscrossed the high ceiling, the exposed beams clearly meant to evoke a Swiss chalet.

A large set of sofas were arranged around a huge rug. A dark wine stain was conspicuous on the armrest, standing out on the white fabric. Everything in the room faced a gray slate fireplace. 

A small spiral staircase in the corner led up to a reading nook, which was open to the greatroom, separated by a wooden balustrade. Coming from somewhere up there I heard "We Three Kings" warbling from what sounded like an old radio.

Turn Count: 91
FoundClues: 8

I beg your pardon?

>east
Downstairs Hallway
A long narrow corridor connected the entrance of the house with the bedrooms. Lights were recessed into the ceiling overhead, shining down onto the polished wood floor. Maybe some people liked this sterile modern crap, but it made the place look like an art gallery, as far as I was concerned. A couple of paintings even adorned the walls, so maybe that was the idea, and I was just uncultured.

Turn Count: 92
FoundClues: 8
Through the stillness of the house, I heard yelling upstairs. It started as a panicked cry of shock and surprise, but quickly turned to screams of agony. It went on, loud and incoherent, muffled by the wooden walls of the house, getting more raspy and strangled, like a pillow smothering a face. Then, just as suddenly, it stopped. I felt a lump in my stomach like a lead weight, and reached for a gun that wasn't there.
(press any key)

>down
Wine Cellar
The second I walked into the dark wine cellar, recessed lights in the ceiling turned on, probably activated by a motion sensor. 

 A wine rack ran the perimeter of the room, holding enough bottles to supply a French restaurant. A few seemed to be missing here and there. A wooden chair sat in the corner.

I was so focused on trying to read the labels on the fuse box that I didn't notice the footsteps behind me. Maybe I wouldn't have anyway. I heard a dull crack and realized it was the sound of a heavy bottle hitting the back of my head. It was the last thing I remembered thinking about before the rush of unconsciousness. I was out before I hit the floor.
(press any key)
Wine Cellar
I woke up with a headache like I'd kissed the Long Island Express goodnight. When I tried to put my hands up to feel the back of my head, I realized it was tied to the chair, along with my legs. He'd gotten the drop on me, that was for sure.

Well, I was in pretty deep now. I looked around the dark room. No one to talk to but myself.

I could see myself here.

Val opened the door noiselessly behind him. She tiptoed behind him quietly on stockinged feet, her eyes never leaving him. She moved deliberately and gracefully, like a show I'd once seen of a panther stalking an impala. Neither of them seemed to really be in a hurry.
Total number of quips left: 1
Turn Count: 93
FoundClues: 8
I could have ask how he planned on getting away.

I beg your pardon?

>ask how he planned on getting away
You seriously plan to just kill us and get out of here?

Val opened the door noiselessly behind him. She tiptoed behind him quietly on stockinged feet, her eyes never leaving him. She moved deliberately and gracefully, like a show I'd once seen of a panther stalking an impala. Neither of them seemed to really be in a hurry.
Total number of quips left: 1
It'll be easy. A house full of corpses turned to ash, I can just make sure it looks like mine is among them. I disappear, and start over with a new life. It's easy enough to pull off, we all have to do it every fifty years or so. No one will come looking for me, we'll just be tragic victims of some rogue hunter. I take care of you and the lady, open all the shutters, and that's that. Come sundown, that makes a clean getaway.

Turn Count: 94
FoundClues: 8
His eyes went wild, and for a moment I felt like I could actually see his nerves fray and snap. His upper lip curled back over bared teeth so far it looked inhuman. It was the yellow-eyed look of a wolf baring its fangs. He was no wolf, but maybe he was so livid, he'd just forgotten. He whirled the gun around to point it straight at Val's serene face, and pulled the trigger. Her head was nowhere near the gun when it went off. She'd ducked to the side faster than I'd seen anyone move before, like Mayweather slipping a punch.

When Scott tried to aim the gun at her this time, screaming an unearthly scream, her hands were already up in a blur. She let him get another shot off, which I remember thinking was pretty charitable of her. There was nothing resembling charity in her green eyes, burning with a cold fury. It seemed for a second like she'd disarmed him as the gun dropped to the floor. It took an eternity to fall. Then I noticed in the dim light of the wine cellar a glint of silver attached to his neck, a small knife labeled with the initials "AHB." His empty hands went to his throat, and he crumpled over. We listened to quiet gasping for a minute as Val came over to untie me from the chair. By the time she'd finished, it had stopped.

>scenes
Scene 'Entire Game' playing (for 94 mins now)
Scene 'Mountain_Driving' ended
Scene 'Car_Escape' ended
Scene 'Cliff_Climbing' ended
Scene 'Car_Embarking' ended
Scene 'Riding_Scene' ended
Scene 'Body_Discovery' ended
Scene 'Prearrival' ended
Scene 'Guest_Arrival' ended
Scene 'First_Investigation' ended
Scene 'First_Sleep' ended
Scene 'Wakeup' ended
Scene 'Interrogation' ended
Scene 'Second_Investigation' ended
Scene 'ComingBack' ended
Scene 'DiscoverDet' ended
Scene 'CellarThink' ended
Scene 'VillainMonologue' ended
(Scene monitoring now switched on. Type "scenes off" to switch it off again.)

>up
Downstairs Hallway
A long narrow corridor connected the entrance of the house with the bedrooms. Lights were recessed into the ceiling overhead, shining down onto the polished wood floor. Maybe some people liked this sterile modern crap, but it made the place look like an art gallery, as far as I was concerned. A couple of paintings even adorned the walls, so maybe that was the idea, and I was just uncultured.

Turn Count: 95
FoundClues: 8

>w
Greatroom
The greatroom was clearly where the occupants of the house were meant to spend the majority of their time. Tall, dark wooden rafters criscrossed the high ceiling, the exposed beams clearly meant to evoke a Swiss chalet.

A large set of sofas were arranged around a huge rug. A dark wine stain was conspicuous on the armrest, standing out on the white fabric. Everything in the room faced a gray slate fireplace. 

A small spiral staircase in the corner led up to a reading nook, which was open to the greatroom, separated by a wooden balustrade. Coming from somewhere up there I heard "God Rest Ye Merry, Gentlemen" warbling from what sounded like an old radio.

Turn Count: 96
FoundClues: 8

>w
Foyer
I walked into the spacious foyer, trying not to walk into the large lacquered wood screens in front of the door. The shiny black surfaces were decorated with an intricate picture in gold paint, depicting a Chinese court scene. It seemed at odds with the exterior of the house, but matched the rest of the decor; the interior was a mixture of Old World furniture and Asian influences. 

Turn Count: 97
FoundClues: 8

>w
(first opening the front door)
It seemed to be locked.

Turn Count: 98
FoundClues: 8

* * *

I beg your pardon?

>scenes
Scene 'Entire Game' playing (for 93 mins now)
Scene 'Mountain_Driving' ended
Scene 'Car_Escape' ended
Scene 'Cliff_Climbing' ended
Scene 'Car_Embarking' ended
Scene 'Riding_Scene' ended
Scene 'Body_Discovery' ended
Scene 'Prearrival' ended
Scene 'Guest_Arrival' ended
Scene 'First_Investigation' ended
Scene 'First_Sleep' ended
Scene 'Wakeup' ended
Scene 'Interrogation' ended
Scene 'Second_Investigation' ended
Scene 'ComingBack' ended
Scene 'DiscoverDet' ended
Scene 'CellarThink' ended
Scene 'VillainMonologue' playing (for 1 mins now)
(Scene monitoring now switched on. Type "scenes off" to switch it off again.)

>look
Wine Cellar
I woke up with a headache like I'd kissed the Long Island Express goodnight. When I tried to put my hands up to feel the back of my head, I realized it was tied to the chair, along with my legs. He'd gotten the drop on me, that was for sure.

Well, I was in pretty deep now. I looked around the dark room. No one to talk to but myself.

I could see Scott here.

Total number of quips left: 0
Turn Count: 94
FoundClues: 8

>talk to scott
I wasn't talking to anyone.

>scope
1: Scott (864736)
2: myself (859616)
3: a wooden chair (862048)
4: a wine rack (862080)
5: a bank statement (861920)
6: a glass shard (861152)
7: a broken wineglass (861184)
8: a cell phone (859648)

>talk to scott
I wasn't talking to anyone.

>talk to scott_villain
I said hello to Scott.

Total number of quips left: 1
Turn Count: 95
FoundClues: 8
I could have ask how he plans to get away with this.

>stop talking
(to Scott)
I stopped talking to Scott and turned my attention elsewhere.

Total number of quips left: 0
Turn Count: 96
FoundClues: 8

>rules
Rules tracing now switched on. Type "rules off" to switch it off again, or "rules all" to include even rules which do not apply.

>talk to scott
[Rule "flatten ifs rule" applies.]
[Rule "thrashing hopelessly rule" applies.]
[Rule "After reading a command" applies.]
[Rule "After reading a command" applies.]
[Rule "After reading a command" applies.]
[Rule "After reading a command" applies.]
[Rule "After reading a command" applies.]
[Rule "quip scope handling rule" applies.]
[Rule "quips are not visible rule" applies.]
I wasn't talking to anyone.

* * *

I beg your pardon?

>scope
1: Scott_Villain (863744)
2: myself (858624)
3: a wooden chair (861056)
4: a wine rack (861088)
5: a bank statement (860928)
6: a glass shard (860160)
7: a broken wineglass (860192)
8: a cell phone (858656)

>x myself
As good-looking as ever.

Turn Count: 94
FoundClues: 8

>look
Wine Cellar
I woke up with a headache like I'd kissed the Long Island Express goodnight. When I tried to put my hands up to feel the back of my head, I realized it was tied to the chair, along with my legs. He'd gotten the drop on me, that was for sure.

Well, I was in pretty deep now. I looked around the dark room. No one to talk to but myself.

I could see Scott_Villain here.

Turn Count: 95
FoundClues: 8

>talk to myself
Talking to myself was unrewarding at the moment.

Turn Count: 96
FoundClues: 8

>scenes
Scene 'Entire Game' playing (for 96 mins now)
Scene 'Mountain_Driving' ended
Scene 'Car_Escape' ended
Scene 'Cliff_Climbing' ended
Scene 'Car_Embarking' ended
Scene 'Riding_Scene' ended
Scene 'Body_Discovery' ended
Scene 'Prearrival' ended
Scene 'Guest_Arrival' ended
Scene 'First_Investigation' ended
Scene 'First_Sleep' ended
Scene 'Wakeup' ended
Scene 'Interrogation' ended
Scene 'Second_Investigation' ended
Scene 'ComingBack' ended
Scene 'DiscoverDet' ended
Scene 'CellarThink' ended
Scene 'VillainMonologue' playing (for 4 mins now)
(Scene monitoring now switched on. Type "scenes off" to switch it off again.)

* * *

>look
Wine Cellar
I woke up with a headache like I'd kissed the Long Island Express goodnight. When I tried to put my hands up to feel the back of my head, I realized it was tied to the chair, along with my legs. He'd gotten the drop on me, that was for sure.

Well, I was in pretty deep now. I looked around the dark room. No one to talk to but myself.

I could see Scott here.

Total number of quips left: 1
Turn Count: 94
FoundClues: 8
I could have ask how he planned on getting away with this.

* * *

I beg your pardon?

>scenes
Scene 'Entire Game' playing (for 94 mins now)
Scene 'Mountain_Driving' ended
Scene 'Car_Escape' ended
Scene 'Cliff_Climbing' ended
Scene 'Car_Embarking' ended
Scene 'Riding_Scene' ended
Scene 'Body_Discovery' ended
Scene 'Prearrival' ended
Scene 'Guest_Arrival' ended
Scene 'First_Investigation' ended
Scene 'First_Sleep' ended
Scene 'Wakeup' ended
Scene 'Interrogation' ended
Scene 'Second_Investigation' ended
Scene 'ComingBack' ended
Scene 'DiscoverDet' ended
Scene 'CellarThink' ended
Scene 'VillainMonologue' ended
Scene 'GetOutOfDodge' ended
(Scene monitoring now switched on. Type "scenes off" to switch it off again.)

>wait
Time passed.

Turn Count: 95
FoundClues: 8

>up
Downstairs Hallway
A long narrow corridor connected the entrance of the house with the bedrooms. Lights were recessed into the ceiling overhead, shining down onto the polished wood floor. Maybe some people liked this sterile modern crap, but it made the place look like an art gallery, as far as I was concerned. A couple of paintings even adorned the walls, so maybe that was the idea, and I was just uncultured.

Turn Count: 96
FoundClues: 8

>w
Greatroom
The greatroom was clearly where the occupants of the house were meant to spend the majority of their time. Tall, dark wooden rafters criscrossed the high ceiling, the exposed beams clearly meant to evoke a Swiss chalet.

A large set of sofas were arranged around a huge rug. A dark wine stain was conspicuous on the armrest, standing out on the white fabric. Everything in the room faced a gray slate fireplace. 

A small spiral staircase in the corner led up to a reading nook, which was open to the greatroom, separated by a wooden balustrade. Coming from somewhere up there I heard "O Come, All Ye Faithful" warbling from what sounded like an old radio.

Turn Count: 97
FoundClues: 8

>w
Foyer
I walked into the spacious foyer, trying not to walk into the large lacquered wood screens in front of the door. The shiny black surfaces were decorated with an intricate picture in gold paint, depicting a Chinese court scene. It seemed at odds with the exterior of the house, but matched the rest of the decor; the interior was a mixture of Old World furniture and Asian influences. 

Turn Count: 98
FoundClues: 8

>w
(first opening the front door)
It seemed to be locked.

Turn Count: 99
FoundClues: 8

* * *

>up
Downstairs Hallway
A long narrow corridor connected the entrance of the house with the bedrooms. Lights were recessed into the ceiling overhead, shining down onto the polished wood floor. Maybe some people liked this sterile modern crap, but it made the place look like an art gallery, as far as I was concerned. A couple of paintings even adorned the walls, so maybe that was the idea, and I was just uncultured.

Turn Count: 95
FoundClues: 8

>west
Greatroom
The greatroom was clearly where the occupants of the house were meant to spend the majority of their time. Tall, dark wooden rafters criscrossed the high ceiling, the exposed beams clearly meant to evoke a Swiss chalet.

A large set of sofas were arranged around a huge rug. A dark wine stain was conspicuous on the armrest, standing out on the white fabric. Everything in the room faced a gray slate fireplace. 

A small spiral staircase in the corner led up to a reading nook, which was open to the greatroom, separated by a wooden balustrade. Coming from somewhere up there I heard "God Rest Ye Merry, Gentlemen" warbling from what sounded like an old radio.

Turn Count: 96
FoundClues: 8

>west
Foyer
I walked into the spacious foyer, trying not to walk into the large lacquered wood screens in front of the door. The shiny black surfaces were decorated with an intricate picture in gold paint, depicting a Chinese court scene. It seemed at odds with the exterior of the house, but matched the rest of the decor; the interior was a mixture of Old World furniture and Asian influences. 

Turn Count: 97
FoundClues: 8

>wait
The shutters clicked open, the most musical sound I'd ever heard in my life.

Turn Count: 98
FoundClues: 8

>west
(first opening the front door)

Front Porch
Steps led up from the gravel driveway to the porch. Narrow unpainted wood planks extended the length of the house, along with windows that looked into rooms at the front of the house. Through them, I saw blinds, and a glint of something metallic, like a shutter.

The front door stood open.

Turn Count: 99
FoundClues: 8

>west
Driveway
We stood at the end of a long gravel drive, staring up at a large house with a dark red wood exterior. Steps to the east led to a porch that spanned the facade of the place, wrapping around to a deck in the back that presumably had a great view of the lake and the countryside. It was more ski lodge than cabin, and looked like it could comfortably shelter an entire biathlon team if it had to.

Val's Mercedes was parked to one side of the driveway.

I could also see Val_SecondInv_TODO here.

Turn Count: 100
FoundClues: 8

>get in Mercedes
I walked to the Mercedes and she and I looked at each other over the roof. I didn't realize I was on the driver's side until she tossed me the keys.
"That was some good work back there."
I shrugged, and not out of modesty. It was going to be a while before I got used to operating like this.
"Hey kid... Thanks."
I smiled, and the muscles felt stiff. "So where we headed?"
"What was the last time you were in Vegas, kid?" We got in and I started the car. "It's a long story, let me start at the beginning," she said.

We started off down the road and we began to talk, really talk, for the first time since I'd met her. We started off down the long road to the Mojave, in the shadow of the  mountain, high above the valley and its waves and ribbons of untouched snow like an unmade bed. 

I was already getting thirsty, and no quantity of expensive bourbon was going to help.

    *** The End ***

Would you like to RESTART, RESTORE a saved game, QUIT or UNDO the last command?

I beg your pardon?

>scene
That noun did not make sense in this context.

>scenes
Scene 'Entire Game' playing (for 101 mins now)
Scene 'Mountain_Driving' ended
Scene 'Car_Escape' ended
Scene 'Cliff_Climbing' ended
Scene 'Car_Embarking' ended
Scene 'Riding_Scene' ended
Scene 'Body_Discovery' ended
Scene 'Prearrival' ended
Scene 'Guest_Arrival' ended
Scene 'First_Investigation' ended
Scene 'First_Sleep' ended
Scene 'Wakeup' ended
Scene 'Interrogation' ended
Scene 'Second_Investigation' ended
Scene 'ComingBack' ended
Scene 'DiscoverDet' ended
Scene 'CellarThink' ended
Scene 'VillainMonologue' ended
Scene 'GetOutOfDodge' ended
Scene 'Conclusion' playing (for 4 mins now)
(Scene monitoring now switched on. Type "scenes off" to switch it off again.)

>get out
I got out of the Mercedes.

Driveway
We stood at the end of a long gravel drive, staring up at a large house with a dark red wood exterior. Steps to the east led to a porch that spanned the facade of the place, wrapping around to a deck in the back that presumably had a great view of the lake and the countryside. It was more ski lodge than cabin, and looked like it could comfortably shelter an entire biathlon team if it had to.

Val's Mercedes was parked to one side of the driveway.

I could also see Val_SecondInv_TODO here.

Turn Count: 102
FoundClues: 8

>scope
1: myself (864344)
2: a Mercedes (865016)
3: Val_SecondInv_TODO (868984)
4: House (865272)
5: the driveway (865304)
6: a bank statement (866648)
7: a glass shard (865880)
8: a broken wineglass (865912)
9: a cell phone (864376)

* * *

>up
Downstairs Hallway
A long narrow corridor connected the entrance of the house with the bedrooms. Lights were recessed into the ceiling overhead, shining down onto the polished wood floor. Maybe some people liked this sterile modern crap, but it made the place look like an art gallery, as far as I was concerned. A couple of paintings even adorned the walls, so maybe that was the idea, and I was just uncultured.

Turn Count: 95
FoundClues: 8

>scenes
Scene 'Entire Game' playing (for 95 mins now)
Scene 'Mountain_Driving' ended
Scene 'Car_Escape' ended
Scene 'Cliff_Climbing' ended
Scene 'Car_Embarking' ended
Scene 'Riding_Scene' ended
Scene 'Body_Discovery' ended
Scene 'Prearrival' ended
Scene 'Guest_Arrival' ended
Scene 'First_Investigation' ended
Scene 'First_Sleep' ended
Scene 'Wakeup' ended
Scene 'Interrogation' ended
Scene 'Second_Investigation' ended
Scene 'ComingBack' ended
Scene 'DiscoverDet' ended
Scene 'CellarThink' ended
Scene 'VillainMonologue' ended
Scene 'GetOutOfDodge' playing (for 1 mins now)
(Scene monitoring now switched on. Type "scenes off" to switch it off again.)

>west
Greatroom
The greatroom was clearly where the occupants of the house were meant to spend the majority of their time. Tall, dark wooden rafters criscrossed the high ceiling, the exposed beams clearly meant to evoke a Swiss chalet.

A large set of sofas were arranged around a huge rug. A dark wine stain was conspicuous on the armrest, standing out on the white fabric. Everything in the room faced a gray slate fireplace. 

A small spiral staircase in the corner led up to a reading nook, which was open to the greatroom, separated by a wooden balustrade. Coming from somewhere up there I heard "Hark, The Herald Angels Sing" warbling from what sounded like an old radio.

Turn Count: 96
FoundClues: 8

>west
Foyer
I walked into the spacious foyer, trying not to walk into the large lacquered wood screens in front of the door. The shiny black surfaces were decorated with an intricate picture in gold paint, depicting a Chinese court scene. It seemed at odds with the exterior of the house, but matched the rest of the decor; the interior was a mixture of Old World furniture and Asian influences. 

Turn Count: 97
FoundClues: 8

>west
(first opening the front door)
It seemed to be locked.

Turn Count: 98
FoundClues: 8

>wait
The shutters clicked open, the most musical sound I'd ever heard in my life.

[Scene 'GetOutOfDodge' ends]
Turn Count: 99
FoundClues: 8

>west
(first opening the front door)

Front Porch
Steps led up from the gravel driveway to the porch. Narrow unpainted wood planks extended the length of the house, along with windows that looked into rooms at the front of the house. Through them, I saw blinds, and a glint of something metallic, like a shutter.

The front door stood open.

Turn Count: 100
FoundClues: 8

>west
Driveway
We stood at the end of a long gravel drive, staring up at a large house with a dark red wood exterior. Steps to the east led to a porch that spanned the facade of the place, wrapping around to a deck in the back that presumably had a great view of the lake and the countryside. It was more ski lodge than cabin, and looked like it could comfortably shelter an entire biathlon team if it had to.

Val's Mercedes was parked to one side of the driveway.

I could also see Val_SecondInv_TODO here.

Turn Count: 101
FoundClues: 8

>scenes
Scene 'Entire Game' playing (for 101 mins now)
Scene 'Mountain_Driving' ended
Scene 'Car_Escape' ended
Scene 'Cliff_Climbing' ended
Scene 'Car_Embarking' ended
Scene 'Riding_Scene' ended
Scene 'Body_Discovery' ended
Scene 'Prearrival' ended
Scene 'Guest_Arrival' ended
Scene 'First_Investigation' ended
Scene 'First_Sleep' ended
Scene 'Wakeup' ended
Scene 'Interrogation' ended
Scene 'Second_Investigation' ended
Scene 'ComingBack' ended
Scene 'DiscoverDet' ended
Scene 'CellarThink' ended
Scene 'VillainMonologue' ended
Scene 'GetOutOfDodge' ended
(Scene monitoring now switched on. Type "scenes off" to switch it off again.)

>scope
1: myself (863004)
2: a Mercedes (863676)
3: Val_SecondInv_TODO (867644)
4: House (863932)
5: the driveway (863964)
6: a bank statement (865308)
7: a glass shard (864540)
8: a broken wineglass (864572)
9: a cell phone (863036)

>get in
I got into the Mercedes.

Turn Count: 102
FoundClues: 8

* * *

>west
Sharp Bend
I walked on the snowy road about a hundred feet from the hairpin turn where my car had gone over; I could see the tire tracks and broken guardrail to the east.

A Mercedes is quietly idling here, V8 purring.

I could also see Val_SecondInv_TODO here.

Turn Count: 87
FoundClues: 8

>east
Bottom of Cliff
I stood on a ridge densely packed with trees some ways below the highway. My wrecked car sat a few feet away. The ridge extended as far as I could see to the north, going nowhere in particular. To the west I saw the steep incline the car had rolled down, and the path it'd cut through the snow and brush.

My Toyota Corolla in a fetching "Regatta Blue" that must have looked appealing under bright dealership lights when it was brand new back in 1990. I wouldn't know. It now sat on its side like a beached whale, exactly where I'd left it. The key was still in the ignition.
 The power was on, and the dashboard blinked orange and red lights at me.

Turn Count: 88
FoundClues: 8

>east
I couldn't go that way.

Turn Count: 89
FoundClues: 8

>east
I couldn't go that way.

Turn Count: 90
FoundClues: 8

I beg your pardon?

>east
I couldn't go that way.

Turn Count: 91
FoundClues: 8

>down
I couldn't go that way.

Turn Count: 92
FoundClues: 8

I beg your pardon?

>look
Bottom of Cliff
I stood on a ridge densely packed with trees some ways below the highway. My wrecked car sat a few feet away. The ridge extended as far as I could see to the north, going nowhere in particular. To the west I saw the steep incline the car had rolled down, and the path it'd cut through the snow and brush.

My Toyota Corolla in a fetching "Regatta Blue" that must have looked appealing under bright dealership lights when it was brand new back in 1990. I wouldn't know. It now sat on its side like a beached whale, exactly where I'd left it. The key was still in the ignition.
 The power was on, and the dashboard blinked orange and red lights at me.

Turn Count: 93
FoundClues: 8

* * *

>kick windshield
The seat belt held me firmly in place in what was now the bottom of the upturned car. I wasn't going to be able to see or do much of anything until I unbuckled myself.

>west
The seat belt held me firmly in place in what was now the bottom of the upturned car. I wasn't going to be able to see or do much of anything until I unbuckled myself.

>get in
The seat belt held me firmly in place in what was now the bottom of the upturned car. I wasn't going to be able to see or do much of anything until I unbuckled myself.

>talk to val
The seat belt held me firmly in place in what was now the bottom of the upturned car. I wasn't going to be able to see or do much of anything until I unbuckled myself.

>ask about her car
The seat belt held me firmly in place in what was now the bottom of the upturned car. I wasn't going to be able to see or do much of anything until I unbuckled myself.

>ask about the chalet
The seat belt held me firmly in place in what was now the bottom of the upturned car. I wasn't going to be able to see or do much of anything until I unbuckled myself.

>ask about sunrise
The seat belt held me firmly in place in what was now the bottom of the upturned car. I wasn't going to be able to see or do much of anything until I unbuckled myself.

>wait
The seat belt held me firmly in place in what was now the bottom of the upturned car. I wasn't going to be able to see or do much of anything until I unbuckled myself.

>east
The seat belt held me firmly in place in what was now the bottom of the upturned car. I wasn't going to be able to see or do much of anything until I unbuckled myself.

>examine door
The seat belt held me firmly in place in what was now the bottom of the upturned car. I wasn't going to be able to see or do much of anything until I unbuckled myself.

>examine lock
The seat belt held me firmly in place in what was now the bottom of the upturned car. I wasn't going to be able to see or do much of anything until I unbuckled myself.

>east
The seat belt held me firmly in place in what was now the bottom of the upturned car. I wasn't going to be able to see or do much of anything until I unbuckled myself.

>east
The seat belt held me firmly in place in what was now the bottom of the upturned car. I wasn't going to be able to see or do much of anything until I unbuckled myself.

>examine stain
The seat belt held me firmly in place in what was now the bottom of the upturned car. I wasn't going to be able to see or do much of anything until I unbuckled myself.

>look
Upturned Car
I wasn't sure how long I'd been out. Taking stock of my situation, I was surprised to find myself more or less unhurt, save for a dull ache in my left wrist where I'd tried to brace against the door. I took a few deep breaths, and tried to gather myself-- I was still a little mentally a little shocked and unfocused.

The car was presently lying at the bottom of a cliff on its side. Above me, I could see moonlight, dimly mottled by the snow on the passenger side windows. The windshield in front of me showed nothing but evergreen forest, extending into the darkness.

I was still strapped in, the seat belt made sure I stayed put. At least one thing in this car still knew how to do its job right.

Turn Count: 1
FoundClues: 0

>examine shard
The seat belt held me firmly in place in what was now the bottom of the upturned car. I wasn't going to be able to see or do much of anything until I unbuckled myself.

>examine broken wineglass
The seat belt held me firmly in place in what was now the bottom of the upturned car. I wasn't going to be able to see or do much of anything until I unbuckled myself.

>take all
The seat belt held me firmly in place in what was now the bottom of the upturned car. I wasn't going to be able to see or do much of anything until I unbuckled myself.

>up
The seat belt held me firmly in place in what was now the bottom of the upturned car. I wasn't going to be able to see or do much of anything until I unbuckled myself.

>examine bottle
The seat belt held me firmly in place in what was now the bottom of the upturned car. I wasn't going to be able to see or do much of anything until I unbuckled myself.

>examine wineglass
The seat belt held me firmly in place in what was now the bottom of the upturned car. I wasn't going to be able to see or do much of anything until I unbuckled myself.

>examine body
The seat belt held me firmly in place in what was now the bottom of the upturned car. I wasn't going to be able to see or do much of anything until I unbuckled myself.

>examine knife
The seat belt held me firmly in place in what was now the bottom of the upturned car. I wasn't going to be able to see or do much of anything until I unbuckled myself.

>examine pool
The seat belt held me firmly in place in what was now the bottom of the upturned car. I wasn't going to be able to see or do much of anything until I unbuckled myself.

>down
The seat belt held me firmly in place in what was now the bottom of the upturned car. I wasn't going to be able to see or do much of anything until I unbuckled myself.

>up
The seat belt held me firmly in place in what was now the bottom of the upturned car. I wasn't going to be able to see or do much of anything until I unbuckled myself.

>down
The seat belt held me firmly in place in what was now the bottom of the upturned car. I wasn't going to be able to see or do much of anything until I unbuckled myself.

>west
The seat belt held me firmly in place in what was now the bottom of the upturned car. I wasn't going to be able to see or do much of anything until I unbuckled myself.

>examine Nathan
The seat belt held me firmly in place in what was now the bottom of the upturned car. I wasn't going to be able to see or do much of anything until I unbuckled myself.

>examine Scott
The seat belt held me firmly in place in what was now the bottom of the upturned car. I wasn't going to be able to see or do much of anything until I unbuckled myself.

>examine Jan
The seat belt held me firmly in place in what was now the bottom of the upturned car. I wasn't going to be able to see or do much of anything until I unbuckled myself.

>east
The seat belt held me firmly in place in what was now the bottom of the upturned car. I wasn't going to be able to see or do much of anything until I unbuckled myself.

>talk to val
The seat belt held me firmly in place in what was now the bottom of the upturned car. I wasn't going to be able to see or do much of anything until I unbuckled myself.

I beg your pardon?

>ask about Alan
The seat belt held me firmly in place in what was now the bottom of the upturned car. I wasn't going to be able to see or do much of anything until I unbuckled myself.

>ask about nathaniel
The seat belt held me firmly in place in what was now the bottom of the upturned car. I wasn't going to be able to see or do much of anything until I unbuckled myself.

>ask what was in it for me
The seat belt held me firmly in place in what was now the bottom of the upturned car. I wasn't going to be able to see or do much of anything until I unbuckled myself.

>east
The seat belt held me firmly in place in what was now the bottom of the upturned car. I wasn't going to be able to see or do much of anything until I unbuckled myself.

>north
The seat belt held me firmly in place in what was now the bottom of the upturned car. I wasn't going to be able to see or do much of anything until I unbuckled myself.

>examine cups
The seat belt held me firmly in place in what was now the bottom of the upturned car. I wasn't going to be able to see or do much of anything until I unbuckled myself.

>examine books
The seat belt held me firmly in place in what was now the bottom of the upturned car. I wasn't going to be able to see or do much of anything until I unbuckled myself.

>open desk
The seat belt held me firmly in place in what was now the bottom of the upturned car. I wasn't going to be able to see or do much of anything until I unbuckled myself.

>examine papers
The seat belt held me firmly in place in what was now the bottom of the upturned car. I wasn't going to be able to see or do much of anything until I unbuckled myself.

>examine bank statement
The seat belt held me firmly in place in what was now the bottom of the upturned car. I wasn't going to be able to see or do much of anything until I unbuckled myself.

>take all
The seat belt held me firmly in place in what was now the bottom of the upturned car. I wasn't going to be able to see or do much of anything until I unbuckled myself.

>south
The seat belt held me firmly in place in what was now the bottom of the upturned car. I wasn't going to be able to see or do much of anything until I unbuckled myself.

>up
The seat belt held me firmly in place in what was now the bottom of the upturned car. I wasn't going to be able to see or do much of anything until I unbuckled myself.

>north
The seat belt held me firmly in place in what was now the bottom of the upturned car. I wasn't going to be able to see or do much of anything until I unbuckled myself.

>west
The seat belt held me firmly in place in what was now the bottom of the upturned car. I wasn't going to be able to see or do much of anything until I unbuckled myself.

>west
The seat belt held me firmly in place in what was now the bottom of the upturned car. I wasn't going to be able to see or do much of anything until I unbuckled myself.

I beg your pardon?

>drink bourbon
The seat belt held me firmly in place in what was now the bottom of the upturned car. I wasn't going to be able to see or do much of anything until I unbuckled myself.

>drink bourbon
The seat belt held me firmly in place in what was now the bottom of the upturned car. I wasn't going to be able to see or do much of anything until I unbuckled myself.

>ask how long
The seat belt held me firmly in place in what was now the bottom of the upturned car. I wasn't going to be able to see or do much of anything until I unbuckled myself.

>sleep
The seat belt held me firmly in place in what was now the bottom of the upturned car. I wasn't going to be able to see or do much of anything until I unbuckled myself.

I beg your pardon?

>east
The seat belt held me firmly in place in what was now the bottom of the upturned car. I wasn't going to be able to see or do much of anything until I unbuckled myself.

>talk to Adrian
The seat belt held me firmly in place in what was now the bottom of the upturned car. I wasn't going to be able to see or do much of anything until I unbuckled myself.

>ask about questioning me
The seat belt held me firmly in place in what was now the bottom of the upturned car. I wasn't going to be able to see or do much of anything until I unbuckled myself.

>ask about questioning val
The seat belt held me firmly in place in what was now the bottom of the upturned car. I wasn't going to be able to see or do much of anything until I unbuckled myself.

>ask how he knew my name
The seat belt held me firmly in place in what was now the bottom of the upturned car. I wasn't going to be able to see or do much of anything until I unbuckled myself.

>ask about my file
The seat belt held me firmly in place in what was now the bottom of the upturned car. I wasn't going to be able to see or do much of anything until I unbuckled myself.

>ask about anyone outside
The seat belt held me firmly in place in what was now the bottom of the upturned car. I wasn't going to be able to see or do much of anything until I unbuckled myself.

>south
The seat belt held me firmly in place in what was now the bottom of the upturned car. I wasn't going to be able to see or do much of anything until I unbuckled myself.

>talk to val
The seat belt held me firmly in place in what was now the bottom of the upturned car. I wasn't going to be able to see or do much of anything until I unbuckled myself.

>ask about herself
The seat belt held me firmly in place in what was now the bottom of the upturned car. I wasn't going to be able to see or do much of anything until I unbuckled myself.

>ask about her family
The seat belt held me firmly in place in what was now the bottom of the upturned car. I wasn't going to be able to see or do much of anything until I unbuckled myself.

>ask about her husband
The seat belt held me firmly in place in what was now the bottom of the upturned car. I wasn't going to be able to see or do much of anything until I unbuckled myself.

>south
The seat belt held me firmly in place in what was now the bottom of the upturned car. I wasn't going to be able to see or do much of anything until I unbuckled myself.

>west
The seat belt held me firmly in place in what was now the bottom of the upturned car. I wasn't going to be able to see or do much of anything until I unbuckled myself.

>talk to val
The seat belt held me firmly in place in what was now the bottom of the upturned car. I wasn't going to be able to see or do much of anything until I unbuckled myself.

>ask about my file
The seat belt held me firmly in place in what was now the bottom of the upturned car. I wasn't going to be able to see or do much of anything until I unbuckled myself.

>ask what she wanted to see me about
The seat belt held me firmly in place in what was now the bottom of the upturned car. I wasn't going to be able to see or do much of anything until I unbuckled myself.

>ask about our first meeting
The seat belt held me firmly in place in what was now the bottom of the upturned car. I wasn't going to be able to see or do much of anything until I unbuckled myself.

>w
The seat belt held me firmly in place in what was now the bottom of the upturned car. I wasn't going to be able to see or do much of anything until I unbuckled myself.

>west
The seat belt held me firmly in place in what was now the bottom of the upturned car. I wasn't going to be able to see or do much of anything until I unbuckled myself.

* * *

>get in
The seat belt held me firmly in place in what was now the bottom of the upturned car. I wasn't going to be able to see or do much of anything until I unbuckled myself.

>east
The seat belt held me firmly in place in what was now the bottom of the upturned car. I wasn't going to be able to see or do much of anything until I unbuckled myself.

>turn on car
The seat belt held me firmly in place in what was now the bottom of the upturned car. I wasn't going to be able to see or do much of anything until I unbuckled myself.

>examine dashboard
The seat belt held me firmly in place in what was now the bottom of the upturned car. I wasn't going to be able to see or do much of anything until I unbuckled myself.

>examine brakes
The seat belt held me firmly in place in what was now the bottom of the upturned car. I wasn't going to be able to see or do much of anything until I unbuckled myself.

>w
The seat belt held me firmly in place in what was now the bottom of the upturned car. I wasn't going to be able to see or do much of anything until I unbuckled myself.

* * *

>west
The seat belt held me firmly in place in what was now the bottom of the upturned car. I wasn't going to be able to see or do much of anything until I unbuckled myself.

>get in car
The seat belt held me firmly in place in what was now the bottom of the upturned car. I wasn't going to be able to see or do much of anything until I unbuckled myself.

>e
The seat belt held me firmly in place in what was now the bottom of the upturned car. I wasn't going to be able to see or do much of anything until I unbuckled myself.

>east
The seat belt held me firmly in place in what was now the bottom of the upturned car. I wasn't going to be able to see or do much of anything until I unbuckled myself.

>scenes
The seat belt held me firmly in place in what was now the bottom of the upturned car. I wasn't going to be able to see or do much of anything until I unbuckled myself.

>look
Upturned Car
I wasn't sure how long I'd been out. Taking stock of my situation, I was surprised to find myself more or less unhurt, save for a dull ache in my left wrist where I'd tried to brace against the door. I took a few deep breaths, and tried to gather myself-- I was still a little mentally a little shocked and unfocused.

The car was presently lying at the bottom of a cliff on its side. Above me, I could see moonlight, dimly mottled by the snow on the passenger side windows. The windshield in front of me showed nothing but evergreen forest, extending into the darkness.

I was still strapped in, the seat belt made sure I stayed put. At least one thing in this car still knew how to do its job right.

Turn Count: 2
FoundClues: 0

>e
The seat belt held me firmly in place in what was now the bottom of the upturned car. I wasn't going to be able to see or do much of anything until I unbuckled myself.

>down
The seat belt held me firmly in place in what was now the bottom of the upturned car. I wasn't going to be able to see or do much of anything until I unbuckled myself.

>talk to self
The seat belt held me firmly in place in what was now the bottom of the upturned car. I wasn't going to be able to see or do much of anything until I unbuckled myself.

>talk to myself
The seat belt held me firmly in place in what was now the bottom of the upturned car. I wasn't going to be able to see or do much of anything until I unbuckled myself.

>talk to me_npc
The seat belt held me firmly in place in what was now the bottom of the upturned car. I wasn't going to be able to see or do much of anything until I unbuckled myself.

* * *

>ask about our first meeting
The seat belt held me firmly in place in what was now the bottom of the upturned car. I wasn't going to be able to see or do much of anything until I unbuckled myself.

>west
The seat belt held me firmly in place in what was now the bottom of the upturned car. I wasn't going to be able to see or do much of anything until I unbuckled myself.

* * *

>examine brakes
The seat belt held me firmly in place in what was now the bottom of the upturned car. I wasn't going to be able to see or do much of anything until I unbuckled myself.

>west
The seat belt held me firmly in place in what was now the bottom of the upturned car. I wasn't going to be able to see or do much of anything until I unbuckled myself.

* * *

>get in car
The seat belt held me firmly in place in what was now the bottom of the upturned car. I wasn't going to be able to see or do much of anything until I unbuckled myself.

>east
The seat belt held me firmly in place in what was now the bottom of the upturned car. I wasn't going to be able to see or do much of anything until I unbuckled myself.

I beg your pardon?

* * *

>unbuckle self
I wrestled with the jammed seat belt for a moment, then managed to undo it, falling a few inches down against the driver door once the chest belt was free.

>kick windshield
Bracing my back against the sideways seat, I gave the windshield a couple of sharp kicks. I felt the seal start to give, and then it dislodged entirely from the frame, making an exit. It fell out onto the snow with a muffled crunch, and the bitter wind started to blow into the old car. I pulled my coat tight around me, and stepped out into the forest.

(press any key)
Bottom of Cliff
I stood on a ridge densely packed with trees some ways below the highway. My wrecked car sat a few feet away. The ridge extended as far as I could see to the north, going nowhere in particular. To the west I saw the steep incline the car had rolled down, and the path it'd cut through the snow and brush.

Turn Count: 1
FoundClues: 0

>west
Sharp Bend
I walked on the snowy road about a hundred feet from the hairpin turn where my car had gone over; I could see the tire tracks and broken guardrail to the east.

The second I turned my head to look down the lane, I saw a pair of headlights approach. A black Mercedes pulled up and came to a stop just in front of me. The passenger door opened, and I saw Val looking out at me.

"Get in," she said.

Turn Count: 2
FoundClues: 0

* * *

>east
Greatroom
The greatroom was clearly where the occupants of the house were meant to spend the majority of their time. Tall, dark wooden rafters criscrossed the high ceiling, the exposed beams clearly meant to evoke a Swiss chalet.

A large set of sofas were arranged around a huge rug. A dark stain was conspicuous on the armrest, standing out on the white fabric. Everything in the room faced a gray slate fireplace. A fire roared inside, fresh logs having been added not too long ago.

A small spiral staircase in the corner led up to a reading nook, which was open to the greatroom, separated by a wooden balustrade. Coming from somewhere up there I heard "O Come, All Ye Faithful" warbling from what sounded like an old radio.

Turn Count: 13
FoundClues: 1

>examine stain
An oblong dark red spot about the size of a pear stood out from the beige couch. From the color, it looked like wine. As I looked at it, I realized something on the floor was reflecting firelight back at me.

Turn Count: 14
FoundClues: 2

>look
Greatroom
The greatroom was clearly where the occupants of the house were meant to spend the majority of their time. Tall, dark wooden rafters criscrossed the high ceiling, the exposed beams clearly meant to evoke a Swiss chalet.

A large set of sofas were arranged around a huge rug. A dark wine stain was conspicuous on the armrest, standing out on the white fabric. Everything in the room faced a gray slate fireplace. A fire roared inside, fresh logs having been added not too long ago.

A small spiral staircase in the corner led up to a reading nook, which was open to the greatroom, separated by a wooden balustrade. Coming from somewhere up there I heard "Angels We Have Heard on High" warbling from what sounded like an old radio.

I could see a glass shard here.

Turn Count: 15
FoundClues: 2

>examine shard
A broken shard of glass. The ruined facets of vintage crystal reflected light like a cheap engagement ring.

I crouched down for a closer look and realized it had come from a shattered wineglass,  the pieces obscured by the sofa.

Turn Count: 16
FoundClues: 2

* * *

>examine knife
It looked like a silver letter opener with an ivory handle. A monogram on the end read "AHB". It didn't look that long or that sharp, but someone had made a pretty clean business of stabbing Bowden with it. Or maybe they'd just gotten lucky. It happens like that sometimes.

Turn Count: 23
FoundClues: 5

* * *

>examine pool
A small pool of red wine had fallen on the rug underneath the table, bleeding out onto the wood floor.

Turn Count: 24
FoundClues: 6

>down
Greatroom
The greatroom was clearly where the occupants of the house were meant to spend the majority of their time. Tall, dark wooden rafters criscrossed the high ceiling, the exposed beams clearly meant to evoke a Swiss chalet.

A large set of sofas were arranged around a huge rug. A dark wine stain was conspicuous on the armrest, standing out on the white fabric. Everything in the room faced a gray slate fireplace. 

A small spiral staircase in the corner led up to a reading nook, which was open to the greatroom, separated by a wooden balustrade. Coming from somewhere up there I heard "Angels We Have Heard on High" warbling from what sounded like an old radio.

Turn Count: 25
FoundClues: 6

>up
Reading Nook
I climbed the stairs to the reading nook. Shelves lined the walls of the small room, and a couple of books had been knocked off them onto the floor. A pair of wingback armchairs faced each other with a coffee table in between. A small pool of red liquid lay underneath the table.

A man sat in one, slightly paunchy and slightly grey, his eyes and mouth wide open. His glasses were askew. He was wearing a navy blue cardigan, stained all over the front with a dark, almost black liquid. What looked like a small knife was sticking out of his neck, plunged in so far that only the handle was visible.

Val stood to my left, looking impassively at the body of Alan Bowden.

An antique wooden radio sat on the table, playing Christmas carols.

I could also see a bottle of wine and a wineglass here.

Turn Count: 26
FoundClues: 6

>down
Greatroom
The greatroom was clearly where the occupants of the house were meant to spend the majority of their time. Tall, dark wooden rafters criscrossed the high ceiling, the exposed beams clearly meant to evoke a Swiss chalet.

A large set of sofas were arranged around a huge rug. A dark wine stain was conspicuous on the armrest, standing out on the white fabric. Everything in the room faced a gray slate fireplace. 

A small spiral staircase in the corner led up to a reading nook, which was open to the greatroom, separated by a wooden balustrade. Coming from somewhere up there I heard "God Rest Ye Merry, Gentlemen" warbling from what sounded like an old radio.

Turn Count: 27
FoundClues: 6

>up
Reading Nook
I climbed the stairs to the reading nook. Shelves lined the walls of the small room, and a couple of books had been knocked off them onto the floor. A pair of wingback armchairs faced each other with a coffee table in between. A small pool of red liquid lay underneath the table.

A man sat in one, slightly paunchy and slightly grey, his eyes and mouth wide open. His glasses were askew. He was wearing a navy blue cardigan, stained all over the front with a dark, almost black liquid. What looked like a small knife was sticking out of his neck, plunged in so far that only the handle was visible.

Val stood to my left, looking impassively at the body of Alan Bowden.

An antique wooden radio sat on the table, playing Christmas carols.

I could also see a bottle of wine and a wineglass here.

Turn Count: 28
FoundClues: 6

>down
Greatroom
The greatroom was clearly where the occupants of the house were meant to spend the majority of their time. Tall, dark wooden rafters criscrossed the high ceiling, the exposed beams clearly meant to evoke a Swiss chalet.

A large set of sofas were arranged around a huge rug. A dark wine stain was conspicuous on the armrest, standing out on the white fabric. Everything in the room faced a gray slate fireplace. 

A small spiral staircase in the corner led up to a reading nook, which was open to the greatroom, separated by a wooden balustrade. Coming from somewhere up there I heard "We Three Kings" warbling from what sounded like an old radio.

Turn Count: 29
FoundClues: 6

>up
Reading Nook
I climbed the stairs to the reading nook. Shelves lined the walls of the small room, and a couple of books had been knocked off them onto the floor. A pair of wingback armchairs faced each other with a coffee table in between. A small pool of red liquid lay underneath the table.

A man sat in one, slightly paunchy and slightly grey, his eyes and mouth wide open. His glasses were askew. He was wearing a navy blue cardigan, stained all over the front with a dark, almost black liquid. What looked like a small knife was sticking out of his neck, plunged in so far that only the handle was visible.

Val stood to my left, looking impassively at the body of Alan Bowden.

An antique wooden radio sat on the table, playing Christmas carols.

I could also see a bottle of wine and a wineglass here.

Turn Count: 30
FoundClues: 6

* * *

>down
Greatroom
The greatroom was clearly where the occupants of the house were meant to spend the majority of their time. Tall, dark wooden rafters criscrossed the high ceiling, the exposed beams clearly meant to evoke a Swiss chalet.

A large set of sofas were arranged around a huge rug. A dark wine stain was conspicuous on the armrest, standing out on the white fabric. Everything in the room faced a gray slate fireplace. 

A small spiral staircase in the corner led up to a reading nook, which was open to the greatroom, separated by a wooden balustrade. Coming from somewhere up there I heard "God Rest Ye Merry, Gentlemen" warbling from what sounded like an old radio.

Turn Count: 33
FoundClues: 6

* * *

>talk to val
I said hello to Val_HouseTODO.

Turn Count: 39
FoundClues: 6
I could have asked ask about Alan, ask about the murder, ask about Nathaniel or ask what was in it for me.

* * *

>ask about nathaniel
"This Nathaniel Wyndham, is he old money?" I asked.

"I guess. He made a sizeable fortune selling boots to the Allies during World War I, a real war profiteer. He used it to buy that ridiculous title, a couple of country estates, and even restored an old manor house. But a little time running with the Circle crowd will tell you that "old money" is a relative term."

Turn Count: 41
FoundClues: 6
I could have asked ask about the murder or ask what was in it for me.

>ask what was in it for me
"Seems like a pretty long way to stick my neck out for you. What's in it for me, exactly?"

She gave me a sharp look. I could tell it got a lot of use, it was just as practiced as everything else about her. Here was a woman who wasn't afraid to throw her weight around, and made it a bad habit to make her do it.

"Think of me as your first client as a private dick. I'm asking you to make this one on the house. You owe me, remember?"

She had me there. I didn't know if this was the kind of thing I could pay back, but I didn't like owing that kind of debt.

Turn Count: 42
FoundClues: 6
I could have asked ask about the murder.

>east
Greatroom
The greatroom was clearly where the occupants of the house were meant to spend the majority of their time. Tall, dark wooden rafters criscrossed the high ceiling, the exposed beams clearly meant to evoke a Swiss chalet.

A large set of sofas were arranged around a huge rug. A dark wine stain was conspicuous on the armrest, standing out on the white fabric. Everything in the room faced a gray slate fireplace. A fire roared inside, fresh logs having been added not too long ago.

A small spiral staircase in the corner led up to a reading nook, which was open to the greatroom, separated by a wooden balustrade. Coming from somewhere up there I heard "Hark, The Herald Angels Sing" warbling from what sounded like an old radio.

Turn Count: 43
FoundClues: 6

>east
Downstairs Hallway
A long narrow corridor connected the entrance of the house with the bedrooms. Lights were recessed into the ceiling overhead, shining down onto the polished wood floor. Maybe some people liked this sterile modern crap, but it made the place look like an art gallery, as far as I was concerned. A couple of paintings even adorned the walls, so maybe that was the idea, and I was just uncultured.

Turn Count: 44
FoundClues: 6

>north
Office
Of all the rooms I'd seen in the house, this one looked the most lived in. It had the musty smell of old books mixed with stale coffee coming from several cups on the desk.

I could see a computer here.

Turn Count: 45
FoundClues: 6

>examine cups
Mugs of coffee, stone cold. I could see brown stains on the sides of the half-empty cups where the liquid had evaporated. They'd been here a few days, but that didn't indicate a time of death. The kind of man who leaves more than two coffee cups sitting on a desk isn't in a hurry to clean up after himself.

Turn Count: 46
FoundClues: 6

>examine books
I couldn't see any such thing.

>open desk
I opened the desk, revealing a bank statement.

Turn Count: 47
FoundClues: 6

>examine papers
I thumbed through the pile on the desk, finding term papers and dissertations, collections of academic journals. Underneath most of it was something that caught my eye, a document with dollar signs on it and more zeroes than I'm used to seeing on paper.

Turn Count: 48
FoundClues: 6

>examine bank statement
I saw nothing special about the bank statement.

Turn Count: 49
FoundClues: 7

>take all
bank statement: Taken.

Turn Count: 50
FoundClues: 7

>south
Downstairs Hallway
A long narrow corridor connected the entrance of the house with the bedrooms. Lights were recessed into the ceiling overhead, shining down onto the polished wood floor. Maybe some people liked this sterile modern crap, but it made the place look like an art gallery, as far as I was concerned. A couple of paintings even adorned the walls, so maybe that was the idea, and I was just uncultured.

Turn Count: 51
FoundClues: 7

>up
Upstairs Hallway
Turn Count: 52
FoundClues: 7

>north
North Hallway
Turn Count: 53
FoundClues: 7

>west
(first opening bedroom door)
I reached the room where Val was staying, and supposed it was where I was staying, too. My tired fingers closed tightly around the doorknob like a pitcher throwing his last solid knuckleball in the ninth inning. 

I paused for a moment, mentally tallying what I'd put together about what had happened. I figured I ought to make sure I'd found enough clues for the day before I turned in.

Turn Count: 54
FoundClues: 7

>west
(first opening bedroom door)

Bedroom

I could see a bottle of bourbon here.

Turn Count: 55
FoundClues: 7

I beg your pardon?

>drink bourbon
I poured out a measure into one of the glasses on the nightstand and drank it slowly, letting it linger on my tongue.

I thought about the idea that someone was just outside the window, peering in, waiting the way a hunter sits in a blind, waiting for ducks. I thought about the three men I'd just met, and how I liked none of them. I thought about the man I'd seen in the chair with his eyes wide open, who didn't seem to mind that I was drinking his bourbon, since he didn't mind much of anything anymore.

Turn Count: 56
FoundClues: 7

>drink bourbon
I went back to the bottle and poured again, more generous this time. I listened to the sound of something between snow and frozen rain pattering against the window. I listened to Val's steady breathing. She was either asleep, or thinking just as hard as I was. I stared at her back a long time, trying to decide if I wanted to talk to her.

Turn Count: 57
FoundClues: 7

>drink bourbon
I changed into my pajamas and got into bed under the covers. I kept a reasonable distance between the two of us on the bed, though she didn't seem the type to get prudish about that kind of thing. I lay there thinking for a long time, trying to put together everything I'd heard into a picture that made sense. After five minutes that took two hours, I fell asleep, and dreamt of nothing.

(press any key)
I awoke to an empty room, bathed in the silver moonlight. She hadn't made a sound when she'd left. It took a second for me to realize that the shutters had gone back up. Through the window, I could see that lights were starting to come on in the distant houses dotted across the mountainside.

I wasn't sure how long I'd slept, but it must have been about eight o'clock in the evening.

Turn Count: 58
FoundClues: 7

>ask how long
There was no one there to talk to.

Turn Count: 59
FoundClues: 7

>sleep
I wasn't feeling especially drowsy.

Turn Count: 60
FoundClues: 7

* * *

>south
Downstairs Hallway
A long narrow corridor connected the entrance of the house with the bedrooms. Lights were recessed into the ceiling overhead, shining down onto the polished wood floor. Maybe some people liked this sterile modern crap, but it made the place look like an art gallery, as far as I was concerned. A couple of paintings even adorned the walls, so maybe that was the idea, and I was just uncultured.

I could see Adrian here.

Turn Count: 73
FoundClues: 7

>west
Greatroom
The greatroom was clearly where the occupants of the house were meant to spend the majority of their time. Tall, dark wooden rafters criscrossed the high ceiling, the exposed beams clearly meant to evoke a Swiss chalet.

A large set of sofas were arranged around a huge rug. A dark wine stain was conspicuous on the armrest, standing out on the white fabric. Everything in the room faced a gray slate fireplace. 

A small spiral staircase in the corner led up to a reading nook, which was open to the greatroom, separated by a wooden balustrade. Coming from somewhere up there I heard "Angels We Have Heard on High" warbling from what sounded like an old radio.

Turn Count: 74
FoundClues: 7

>west
Foyer
I walked into the spacious foyer, trying not to walk into the large lacquered wood screens in front of the door. The shiny black surfaces were decorated with an intricate picture in gold paint, depicting a Chinese court scene. It seemed at odds with the exterior of the house, but matched the rest of the decor; the interior was a mixture of Old World furniture and Asian influences. 

I could also see Val_SecondInv_TODO here.

Turn Count: 75
FoundClues: 7

* * *

>ask about our first meeting
"So the first time we met, that wasn't a coincidence, was it?"
"Would you have chosen differently if you'd known?"
"No."
"Then what the hell are you sore about?" She was starting to sound impatient again.

Turn Count: 79
FoundClues: 7

>w
(first opening the front door)

Front Porch
Steps led up from the gravel driveway to the porch. Narrow unpainted wood planks extended the length of the house, along with windows that looked into rooms at the front of the house. Through them, I saw blinds, and a glint of something metallic, like a shutter.

The front door stood open.

Turn Count: 80
FoundClues: 7

>west
Driveway
We stood at the end of a long gravel drive, staring up at a large house with a dark red wood exterior. Steps to the east led to a porch that spanned the facade of the place, wrapping around to a deck in the back that presumably had a great view of the lake and the countryside. It was more ski lodge than cabin, and looked like it could comfortably shelter an entire biathlon team if it had to.

Val's Mercedes was parked to one side of the driveway.

Turn Count: 81
FoundClues: 7

* * *

>w
Sharp Bend
I walked on the snowy road about a hundred feet from the hairpin turn where my car had gone over; I could see the tire tracks and broken guardrail to the east.

A Mercedes is quietly idling here, V8 purring.

I could also see Val_SecondInv_TODO here.

Turn Count: 87
FoundClues: 8

>west
I couldn't go that way.

Turn Count: 88
FoundClues: 8

>get in car
Driveway
We stood at the end of a long gravel drive, staring up at a large house with a dark red wood exterior. Steps to the east led to a porch that spanned the facade of the place, wrapping around to a deck in the back that presumably had a great view of the lake and the countryside. It was more ski lodge than cabin, and looked like it could comfortably shelter an entire biathlon team if it had to.

Val's Mercedes was parked to one side of the driveway.

I could also see Val_SecondInv_TODO here.

Turn Count: 89
FoundClues: 8

>e
Front Porch
Steps led up from the gravel driveway to the porch. Narrow unpainted wood planks extended the length of the house, along with windows that looked into rooms at the front of the house. Through them, I saw blinds, and a glint of something metallic, like a shutter.

The front door stood open.

Turn Count: 90
FoundClues: 8

>east
I walked into the house, taking care to close the door behind me.

Foyer
I walked into the spacious foyer, trying not to walk into the large lacquered wood screens in front of the door. The shiny black surfaces were decorated with an intricate picture in gold paint, depicting a Chinese court scene. It seemed at odds with the exterior of the house, but matched the rest of the decor; the interior was a mixture of Old World furniture and Asian influences. 

Foyer
I walked into the spacious foyer, trying not to walk into the large lacquered wood screens in front of the door. The shiny black surfaces were decorated with an intricate picture in gold paint, depicting a Chinese court scene. It seemed at odds with the exterior of the house, but matched the rest of the decor; the interior was a mixture of Old World furniture and Asian influences. 

I hadn't realized it until I saw an edge of light blue on the horizon, but we'd cut things pretty close again. A quiet whirring of the closing shutters and a click of the lock was the only indication that the sun was about to rise. The foyer went artificially dark again, except for the light of the brass chandelier.

Turn Count: 91
FoundClues: 8

>scenes
Scene 'Entire Game' playing (for 91 mins now)
Scene 'Mountain_Driving' ended
Scene 'Car_Escape' ended
Scene 'Cliff_Climbing' ended
Scene 'Car_Embarking' ended
Scene 'Riding_Scene' ended
Scene 'Body_Discovery' ended
Scene 'Prearrival' ended
Scene 'Guest_Arrival' ended
Scene 'First_Investigation' ended
Scene 'First_Sleep' ended
Scene 'Wakeup' ended
Scene 'Interrogation' ended
Scene 'Second_Investigation' ended
Scene 'ComingBack' playing (for 1 mins now)
(Scene monitoring now switched on. Type "scenes off" to switch it off again.)

>look
Foyer
I walked into the spacious foyer, trying not to walk into the large lacquered wood screens in front of the door. The shiny black surfaces were decorated with an intricate picture in gold paint, depicting a Chinese court scene. It seemed at odds with the exterior of the house, but matched the rest of the decor; the interior was a mixture of Old World furniture and Asian influences. 

Turn Count: 92
FoundClues: 8

>e
Greatroom
The greatroom was clearly where the occupants of the house were meant to spend the majority of their time. Tall, dark wooden rafters criscrossed the high ceiling, the exposed beams clearly meant to evoke a Swiss chalet.

A large set of sofas were arranged around a huge rug. A dark wine stain was conspicuous on the armrest, standing out on the white fabric. Everything in the room faced a gray slate fireplace. 

A small spiral staircase in the corner led up to a reading nook, which was open to the greatroom, separated by a wooden balustrade. Coming from somewhere up there I heard "Hark, The Herald Angels Sing" warbling from what sounded like an old radio.

Turn Count: 93
FoundClues: 8
[Scene 'DiscoverDet' begins]
Through the stillness of the house, I heard yelling upstairs. It started as a panicked cry of shock and surprise, but quickly turned to screams of agony. It went on, loud and incoherent, muffled by the wooden walls of the house, getting more raspy and strangled, like a pillow smothering a face. Then, just as suddenly, it stopped. I felt a lump in my stomach like a lead weight, and reached for a gun that wasn't there.
(press any key)[Scene 'ComingBack' ends]

>down
I couldn't go that way.

Turn Count: 94
FoundClues: 8

>talk to self
Talking to myself was likely to prove unrewarding.

Turn Count: 95
FoundClues: 8

>talk to myself
Talking to myself was likely to prove unrewarding.

Turn Count: 96
FoundClues: 8

>talk to me_npc
That noun did not make sense in this context.

* * *

>east
Greatroom
The greatroom was clearly where the occupants of the house were meant to spend the majority of their time. Tall, dark wooden rafters criscrossed the high ceiling, the exposed beams clearly meant to evoke a Swiss chalet.

A large set of sofas were arranged around a huge rug. A dark wine stain was conspicuous on the armrest, standing out on the white fabric. Everything in the room faced a gray slate fireplace. 

A small spiral staircase in the corner led up to a reading nook, which was open to the greatroom, separated by a wooden balustrade. Coming from somewhere up there I heard "Hark, The Herald Angels Sing" warbling from what sounded like an old radio.

Turn Count: 91
FoundClues: 8

I beg your pardon?

* * *

I beg your pardon?

>scenes
Scene 'Entire Game' playing (for 92 mins now)
Scene 'Mountain_Driving' ended
Scene 'Car_Escape' ended
Scene 'Cliff_Climbing' ended
Scene 'Car_Embarking' ended
Scene 'Riding_Scene' ended
Scene 'Body_Discovery' ended
Scene 'Prearrival' ended
Scene 'Guest_Arrival' ended
Scene 'First_Investigation' ended
Scene 'First_Sleep' ended
Scene 'Wakeup' ended
Scene 'Interrogation' ended
Scene 'Second_Investigation' ended
Scene 'ComingBack' ended
Scene 'DiscoverDet' playing (for 0 mins now)
(Scene monitoring now switched on. Type "scenes off" to switch it off again.)

>look
Downstairs Hallway
A long narrow corridor connected the entrance of the house with the bedrooms. Lights were recessed into the ceiling overhead, shining down onto the polished wood floor. Maybe some people liked this sterile modern crap, but it made the place look like an art gallery, as far as I was concerned. A couple of paintings even adorned the walls, so maybe that was the idea, and I was just uncultured.

Turn Count: 93
FoundClues: 8

>talk to scott
I wasn't talking to anyone.

>scope
1: myself (860640)
2: a painting (862752)
3: a bank statement (862944)
4: a glass shard (862176)
5: a broken wineglass (862208)
6: a cell phone (860672)

>talk to scott
I wasn't talking to anyone.

>talk to scott_villain
That noun did not make sense in this context.

>stop talking
(to myself)
I wasn't talking to myself.

Turn Count: 94
FoundClues: 8

>rules
Rules tracing now switched on. Type "rules off" to switch it off again, or "rules all" to include even rules which do not apply.

* * *

>talk to scott
[Rule "flatten ifs rule" applies.]
[Rule "thrashing hopelessly rule" applies.]
[Rule "After reading a command" applies.]
[Rule "After reading a command" applies.]
[Rule "After reading a command" applies.]
[Rule "After reading a command" applies.]
[Rule "After reading a command" applies.]
[Rule "quip scope handling rule" applies.]
[Rule "quips are not visible rule" applies.]
I wasn't talking to anyone.

>talk to scott_villain
[Rule "flatten ifs rule" applies.]
[Rule "thrashing hopelessly rule" applies.]
[Rule "After reading a command" applies.]
[Rule "After reading a command" applies.]
[Rule "After reading a command" applies.]
[Rule "After reading a command" applies.]
[Rule "After reading a command" applies.]
[Rule "quip scope handling rule" applies.]
[Rule "quips are not visible rule" applies.]
That noun did not make sense in this context.

>stop talking to scott_villain
[Rule "flatten ifs rule" applies.]
[Rule "thrashing hopelessly rule" applies.]
[Rule "After reading a command" applies.]
[Rule "After reading a command" applies.]
[Rule "After reading a command" applies.]
[Rule "After reading a command" applies.]
[Rule "After reading a command" applies.]
[Rule "quips are not visible rule" applies.]
I couldn't see any such thing.

* * *

I beg your pardon?

>ask how he planned on getting away
There was no one there to talk to.

Turn Count: 93
FoundClues: 8

>up
Upstairs Hallway
Turn Count: 94
FoundClues: 8

>west
I couldn't go that way.

Turn Count: 95
FoundClues: 8

>west
I couldn't go that way.

Turn Count: 96
FoundClues: 8

>wait
Time passed.

Turn Count: 97
FoundClues: 8

>west
I couldn't go that way.

Turn Count: 98
FoundClues: 8

>west
I couldn't go that way.

Turn Count: 99
FoundClues: 8

>get in Mercedes
I couldn't see any such thing.

I beg your pardon?

* * *

>scene
That noun did not make sense in this context.

>scenes
Scene 'Entire Game' playing (for 99 mins now)
Scene 'Mountain_Driving' ended
Scene 'Car_Escape' ended
Scene 'Cliff_Climbing' ended
Scene 'Car_Embarking' ended
Scene 'Riding_Scene' ended
Scene 'Body_Discovery' ended
Scene 'Prearrival' ended
Scene 'Guest_Arrival' ended
Scene 'First_Investigation' ended
Scene 'First_Sleep' ended
Scene 'Wakeup' ended
Scene 'Interrogation' ended
Scene 'Second_Investigation' ended
Scene 'ComingBack' ended
Scene 'DiscoverDet' playing (for 7 mins now)
(Scene monitoring now switched on. Type "scenes off" to switch it off again.)

>get out
But I wasn't in anything at the time.

Turn Count: 100
FoundClues: 8

>scope
1: myself (864344)
2: a bank statement (866648)
3: a glass shard (865880)
4: a broken wineglass (865912)
5: a cell phone (864376)

>look
Upstairs Hallway
Turn Count: 101
FoundClues: 8

>scenes
Scene 'Entire Game' playing (for 101 mins now)
Scene 'Mountain_Driving' ended
Scene 'Car_Escape' ended
Scene 'Cliff_Climbing' ended
Scene 'Car_Embarking' ended
Scene 'Riding_Scene' ended
Scene 'Body_Discovery' ended
Scene 'Prearrival' ended
Scene 'Guest_Arrival' ended
Scene 'First_Investigation' ended
Scene 'First_Sleep' ended
Scene 'Wakeup' ended
Scene 'Interrogation' ended
Scene 'Second_Investigation' ended
Scene 'ComingBack' ended
Scene 'DiscoverDet' playing (for 9 mins now)
(Scene monitoring now switched on. Type "scenes off" to switch it off again.)

* * *

>look
Downstairs Hallway
A long narrow corridor connected the entrance of the house with the bedrooms. Lights were recessed into the ceiling overhead, shining down onto the polished wood floor. Maybe some people liked this sterile modern crap, but it made the place look like an art gallery, as far as I was concerned. A couple of paintings even adorned the walls, so maybe that was the idea, and I was just uncultured.

Turn Count: 93
FoundClues: 8

>e
Kitchen
I stepped into a kitchen big enough for a game of football. Wooden cabinets and handsome tile in earth tones went from wall to wall. The quaint country look was somewhat ruined by the collection of modern stainless steel kitchen appliances. They were brand new and it looked like not one of them had been used. It figured, this didn't seem like the kind of place that had a cooking staff.

Turn Count: 94
FoundClues: 8

I beg your pardon?

>w
Downstairs Hallway
A long narrow corridor connected the entrance of the house with the bedrooms. Lights were recessed into the ceiling overhead, shining down onto the polished wood floor. Maybe some people liked this sterile modern crap, but it made the place look like an art gallery, as far as I was concerned. A couple of paintings even adorned the walls, so maybe that was the idea, and I was just uncultured.

Turn Count: 95
FoundClues: 8

>d
Wine Cellar
The second I walked into the dark wine cellar, recessed lights in the ceiling turned on, probably activated by a motion sensor. 

 A wine rack ran the perimeter of the room, holding enough bottles to supply a French restaurant. A few seemed to be missing here and there. A wooden chair sat in the corner.

[Scene 'DiscoverDet' ends]
I was so focused on trying to read the labels on the fuse box that I didn't notice the footsteps behind me. Maybe I wouldn't have anyway. I heard a dull crack and realized it was the sound of a heavy bottle hitting the back of my head. It was the last thing I remembered thinking about before the rush of unconsciousness. I was out before I hit the floor.
(press any key)[Scene 'CellarThink' begins]

Wine Cellar
I woke up with a headache like I'd kissed the Long Island Express goodnight. When I tried to put my hands up to feel the back of my head, I realized it was tied to the chair, along with my legs. He'd gotten the drop on me, that was for sure.

Well, I was in pretty deep now. I looked around the dark room. No one to talk to but myself.

I could see myself here.

[Scene 'CellarThink' ends]
[Scene 'VillainMonologue' begins]
Total number of quips left: 1
Turn Count: 96
FoundClues: 8
I could have ask how he planned on getting away with this.

>ask how he planned on getting away with this
That doesn't seem to be a topic of conversation at the moment.

>ask how he planned on
You seriously plan to just kill us and get out of here?

Total number of quips left: 1
It'll be easy. A house full of corpses turned to ash, I can just make sure it looks like mine is among them. I disappear, and start over with a new life. It's easy enough to pull off, we all have to do it every fifty years or so. No one will come looking for me, we'll just be tragic victims of some rogue hunter.

Turn Count: 97
FoundClues: 8
[Scene 'VillainMonologue' ends]