Mercedes is a subject.
Ski chalet is a subject.
Dawn is a subject.

A Long Drink
An Interactive Fiction by Owen Parks
Release 1 / Serial number 150131 / Inform 7 build 6L38 (I6/v6.33 lib 6/12N) SD

Mountain Road
They say you shouldn't drive when you're angry. That was just one of a hundred pieces of good advice I was ignoring as I drove north along the icy road to the chalet, my foot a little heavier on the gas than it needed to be.

I'd had a long, promising career in homicide ahead of me, or so I kept telling myself, and it was all down the drain now. I had planned on a senior detective's desk being in the cards for me, at least. Maybe even quitting and going into private investigations. Well, I guessed I could still do that.

Not six hours earlier, I'd turned in my badge and my gun and walked out, more or less the way I'd seen it in the movies. The captain was yelling his head off, couldn't figure out why a promising young detective like me would just up and quit. I honestly hoped he never did.

>hint
That noun did not make sense in this context.

* * *

>enter sharp bend
I couldn't see any such thing.

>enter mercedes
Driveway
We stood at the end of a long gravel drive, staring up at a large house with a dark red wood exterior. Steps to the east led to a porch that spanned the facade of the place, wrapping around to a deck in the back that presumably had a great view of the lake and the countryside. It was more ski lodge than cabin, and looked like it could comfortably shelter an entire biathlon team if it had to.

Val's Mercedes was parked to one side of the driveway.

I could also see Val_SecondInv_TODO here.

Turn Count: 64
FoundClues: 5

>e
Front Porch
Steps led up from the gravel driveway to the porch. Narrow unpainted wood planks extended the length of the house, along with windows that looked into rooms at the front of the house. Through them, I saw blinds, and a glint of something metallic, like a shutter.

The front door stood open to the porch.
There was something about the door that looked like a B&E job.

Turn Count: 65
FoundClues: 5

>e
Foyer
I walked into the spacious foyer, trying not to walk into the large lacquered wood screens in front of the door. The shiny black surfaces were decorated with an intricate picture in gold paint, depicting a Chinese court scene. It seemed at odds with the exterior of the house, but matched the rest of the decor; the interior was a mixture of Old World furniture and Asian influences. 

The front door stood open to the porch.
There was something about the door that looked like a B&E job.

Turn Count: 66
FoundClues: 5

>e
Greatroom
The greatroom was clearly where the occupants of the house were meant to spend the majority of their time. Tall, dark wooden rafters criscrossed the high ceiling, the exposed beams clearly meant to evoke a Swiss chalet.

A large set of sofas were arranged around a huge rug. A dark wine stain was conspicuous on the armrest, standing out on the white fabric. Everything in the room faced a gray slate fireplace. 

A small spiral staircase in the corner led up to a reading nook, which was open to the greatroom, separated by a wooden balustrade. Coming from somewhere up there I heard "Angels We Have Heard on High" warbling from what sounded like an old radio.

I could see a broken wineglass and a glass shard here.

Turn Count: 67
FoundClues: 5

>u
Reading Nook
I climbed the stairs to the reading nook. Shelves lined the walls of the small room, and a couple of books had been knocked off them onto the floor. A pair of wingback armchairs faced each other with a coffee table in between. A small pool of red liquid lay underneath the table.

A man sat in one, slightly paunchy and slightly grey, his eyes and mouth wide open. His glasses were askew. He was wearing a navy blue cardigan, stained all over the front with a dark, almost black liquid. What looked like a small knife was sticking out of his neck, plunged in so far that only the handle was visible.

An antique wooden radio sat on the table, playing Christmas carols.

I could also see a bottle of wine and a wineglass here.

Turn Count: 68
FoundClues: 5

>e
I couldn't go that way.

Turn Count: 69
FoundClues: 5

>w
I couldn't go that way.

Turn Count: 70
FoundClues: 5

>d
Greatroom
The greatroom was clearly where the occupants of the house were meant to spend the majority of their time. Tall, dark wooden rafters criscrossed the high ceiling, the exposed beams clearly meant to evoke a Swiss chalet.

A large set of sofas were arranged around a huge rug. A dark wine stain was conspicuous on the armrest, standing out on the white fabric. Everything in the room faced a gray slate fireplace. 

A small spiral staircase in the corner led up to a reading nook, which was open to the greatroom, separated by a wooden balustrade. Coming from somewhere up there I heard "God Rest Ye Merry, Gentlemen" warbling from what sounded like an old radio.

I could see a broken wineglass and a glass shard here.

Turn Count: 71
FoundClues: 5

>w
Foyer
I walked into the spacious foyer, trying not to walk into the large lacquered wood screens in front of the door. The shiny black surfaces were decorated with an intricate picture in gold paint, depicting a Chinese court scene. It seemed at odds with the exterior of the house, but matched the rest of the decor; the interior was a mixture of Old World furniture and Asian influences. 

The front door stood open to the porch.
There was something about the door that looked like a B&E job.

Turn Count: 72
FoundClues: 5

>w
Front Porch
Steps led up from the gravel driveway to the porch. Narrow unpainted wood planks extended the length of the house, along with windows that looked into rooms at the front of the house. Through them, I saw blinds, and a glint of something metallic, like a shutter.

The front door stood open to the porch.
There was something about the door that looked like a B&E job.

Turn Count: 73
FoundClues: 5

>w
Driveway
We stood at the end of a long gravel drive, staring up at a large house with a dark red wood exterior. Steps to the east led to a porch that spanned the facade of the place, wrapping around to a deck in the back that presumably had a great view of the lake and the countryside. It was more ski lodge than cabin, and looked like it could comfortably shelter an entire biathlon team if it had to.

Val's Mercedes was parked to one side of the driveway.

I could also see Val_SecondInv_TODO here.

Turn Count: 74
FoundClues: 5

>get in val's car
Sharp Bend
I stood about a hundred feet from the hairpin turn where my car had gone over; I could see the tire tracks and broken guardrail to the south.

A Mercedes is quietly idling here, V8 purring.

I could also see Val_SecondInv_TODO here.

Turn Count: 75
FoundClues: 5

>s
Hairpin Turn
If I'd finished that last thought a few seconds earlier, I might've noticed the caution sign for the sharp turn, barely visible through the snow. The car was going too fast, and the guardrail came out of nowhere.

Turn Count: 76
FoundClues: 5

I beg your pardon?

I beg your pardon?

>look
Hairpin Turn
If I'd finished that last thought a few seconds earlier, I might've noticed the caution sign for the sharp turn, barely visible through the snow. The car was going too fast, and the guardrail came out of nowhere.

Turn Count: 77
FoundClues: 5

>n
I couldn't go that way.

Turn Count: 78
FoundClues: 5

>s
I couldn't go that way.

Turn Count: 79
FoundClues: 5

>w
I couldn't go that way.

Turn Count: 80
FoundClues: 5

>e
I couldn't go that way.

Turn Count: 81
FoundClues: 5

>exits
north to Sharp Bend and south to Mountain Pass
Turn Count: 82
FoundClues: 5

>n
I couldn't go that way.

Turn Count: 83
FoundClues: 5

* * *

>w
I couldn't go that way.

Turn Count: 64
FoundClues: 5

>d
Bottom of Cliff
I stood on a  ridge densely packed with trees some ways below the highway. My overturned car sat a few feet away. The ridge extended as far as I could see to the north, going nowhere in particular. To the west I saw the steep incline the car had rolled down, and the path it'd cut through the snow and brush.

Turn Count: 65
FoundClues: 5

>w
Sharp Bend
I stood about a hundred feet from the hairpin turn where my car had gone over; I could see the tire tracks and broken guardrail to the south.

A Mercedes is quietly idling here, V8 purring.

I could also see Val_SecondInv_TODO here.

Turn Count: 66
FoundClues: 5

>w
I couldn't go that way.

Turn Count: 67
FoundClues: 5

>w
I couldn't go that way.

Turn Count: 68
FoundClues: 5

>get in val's car
Driveway
We stood at the end of a long gravel drive, staring up at a large house with a dark red wood exterior. Steps to the east led to a porch that spanned the facade of the place, wrapping around to a deck in the back that presumably had a great view of the lake and the countryside. It was more ski lodge than cabin, and looked like it could comfortably shelter an entire biathlon team if it had to.

Val's Mercedes was parked to one side of the driveway.

I could also see Val_SecondInv_TODO here.

Turn Count: 69
FoundClues: 5

>s
I couldn't go that way.

Turn Count: 70
FoundClues: 5

I beg your pardon?

>look
Driveway
We stood at the end of a long gravel drive, staring up at a large house with a dark red wood exterior. Steps to the east led to a porch that spanned the facade of the place, wrapping around to a deck in the back that presumably had a great view of the lake and the countryside. It was more ski lodge than cabin, and looked like it could comfortably shelter an entire biathlon team if it had to.

Val's Mercedes was parked to one side of the driveway.

I could also see Val_SecondInv_TODO here.

Turn Count: 71
FoundClues: 5

>n
I couldn't go that way.

Turn Count: 72
FoundClues: 5

>s
I couldn't go that way.

Turn Count: 73
FoundClues: 5

>w
I couldn't go that way.

Turn Count: 74
FoundClues: 5

>e
Front Porch
Steps led up from the gravel driveway to the porch. Narrow unpainted wood planks extended the length of the house, along with windows that looked into rooms at the front of the house. Through them, I saw blinds, and a glint of something metallic, like a shutter.

The front door stood open to the porch.
There was something about the door that looked like a B&E job.

Turn Count: 75
FoundClues: 5

>exits
east through the front door to the Foyer and west to Driveway
Turn Count: 76
FoundClues: 5

>n
I couldn't go that way.

Turn Count: 77
FoundClues: 5

>n
I couldn't go that way.

Turn Count: 78
FoundClues: 5

>look
Front Porch
Steps led up from the gravel driveway to the porch. Narrow unpainted wood planks extended the length of the house, along with windows that looked into rooms at the front of the house. Through them, I saw blinds, and a glint of something metallic, like a shutter.

The front door stood open to the porch.
There was something about the door that looked like a B&E job.

Turn Count: 79
FoundClues: 5

>w
Driveway
We stood at the end of a long gravel drive, staring up at a large house with a dark red wood exterior. Steps to the east led to a porch that spanned the facade of the place, wrapping around to a deck in the back that presumably had a great view of the lake and the countryside. It was more ski lodge than cabin, and looked like it could comfortably shelter an entire biathlon team if it had to.

Val's Mercedes was parked to one side of the driveway.

I could also see Val_SecondInv_TODO here.

Turn Count: 80
FoundClues: 5

>enter car
I couldn't see any such thing.

>enter mercedes
Sharp Bend
I stood about a hundred feet from the hairpin turn where my car had gone over; I could see the tire tracks and broken guardrail to the south.

A Mercedes is quietly idling here, V8 purring.

I could also see Val_SecondInv_TODO here.

Turn Count: 81
FoundClues: 5

>s
There was nothing interesting that way except for Manhattan, and it was a little far to walk.

Turn Count: 82
FoundClues: 5

>d
Bottom of Cliff
I stood on a  ridge densely packed with trees some ways below the highway. My overturned car sat a few feet away. The ridge extended as far as I could see to the north, going nowhere in particular. To the west I saw the steep incline the car had rolled down, and the path it'd cut through the snow and brush.

Turn Count: 83
FoundClues: 5

>x car
I couldn't see any such thing.

>d
I couldn't go that way.

Turn Count: 84
FoundClues: 5

>w
Sharp Bend
I stood about a hundred feet from the hairpin turn where my car had gone over; I could see the tire tracks and broken guardrail to the south.

A Mercedes is quietly idling here, V8 purring.

I could also see Val_SecondInv_TODO here.

Turn Count: 85
FoundClues: 5

>s
There was nothing interesting that way except for Manhattan, and it was a little far to walk.

Turn Count: 86
FoundClues: 5

>e
I couldn't go that way.

Turn Count: 87
FoundClues: 5

>d
Bottom of Cliff
I stood on a  ridge densely packed with trees some ways below the highway. My overturned car sat a few feet away. The ridge extended as far as I could see to the north, going nowhere in particular. To the west I saw the steep incline the car had rolled down, and the path it'd cut through the snow and brush.

Turn Count: 88
FoundClues: 5

>w
Sharp Bend
I stood about a hundred feet from the hairpin turn where my car had gone over; I could see the tire tracks and broken guardrail to the south.

A Mercedes is quietly idling here, V8 purring.

I could also see Val_SecondInv_TODO here.

Turn Count: 89
FoundClues: 5

>d
Bottom of Cliff
I stood on a  ridge densely packed with trees some ways below the highway. My overturned car sat a few feet away. The ridge extended as far as I could see to the north, going nowhere in particular. To the west I saw the steep incline the car had rolled down, and the path it'd cut through the snow and brush.

Turn Count: 90
FoundClues: 5

>u
Sharp Bend
I stood about a hundred feet from the hairpin turn where my car had gone over; I could see the tire tracks and broken guardrail to the south.

A Mercedes is quietly idling here, V8 purring.

I could also see Val_SecondInv_TODO here.

Turn Count: 91
FoundClues: 5

>e
I couldn't go that way.

Turn Count: 92
FoundClues: 5

>s
There was nothing interesting that way except for Manhattan, and it was a little far to walk.

Turn Count: 93
FoundClues: 5

>d
Bottom of Cliff
I stood on a  ridge densely packed with trees some ways below the highway. My overturned car sat a few feet away. The ridge extended as far as I could see to the north, going nowhere in particular. To the west I saw the steep incline the car had rolled down, and the path it'd cut through the snow and brush.

Turn Count: 94
FoundClues: 5

>exits
north and up to Sharp Bend
Turn Count: 95
FoundClues: 5

>u
Sharp Bend
I stood about a hundred feet from the hairpin turn where my car had gone over; I could see the tire tracks and broken guardrail to the south.

A Mercedes is quietly idling here, V8 purring.

I could also see Val_SecondInv_TODO here.

Turn Count: 96
FoundClues: 5

>exits
south to Hairpin Turn and down to Bottom of Cliff
Turn Count: 97
FoundClues: 5

>s
There was nothing interesting that way except for Manhattan, and it was a little far to walk.

Turn Count: 98
FoundClues: 5

>d
Bottom of Cliff
I stood on a  ridge densely packed with trees some ways below the highway. My overturned car sat a few feet away. The ridge extended as far as I could see to the north, going nowhere in particular. To the west I saw the steep incline the car had rolled down, and the path it'd cut through the snow and brush.

Turn Count: 99
FoundClues: 5

>n
Mountain Ridge
I had a bad feeling as I walked my way along the ridge, trudging a couple of miles through the foot-deep snow. The path didn't seem to be leading anywhere, and the sky kept getting lighter as I went. I still had enough time to turn back, if I wanted.

Turn Count: 100
FoundClues: 5

>n
Dense Forest
I walked for what must have been half an hour through the pines, which kept getting denser. In the light just before dawn, I saw the evergreen foliage come to a sudden stop ahead. I was starting to get seriously worried.

Turn Count: 101
FoundClues: 5

>n
Precipice
The forest abruptly ended in the edge of a cliff, overlooking a valley and several lakes hundreds of feet below.

    *** The north end of the ridge had a stunning view of the eastern valley, and unfortunately the horizon, too. Through what must have been some quirk of fate, I never made it to the chalet. I smiled sardonically at the sunrise, searing like a fire newly kindled, even on that cold, windswept ridge. I guess I'd been spared what would have no doubt been an interminable weekend.

As far as last sights went, I supposed it could have been worse. ***

Would you like to RESTART, RESTORE a saved game, QUIT or UNDO the last command?

>undo
Dense Forest
[Previous turn undone.]

>undo
Mountain Ridge
[Previous turn undone.]

>undo
Bottom of Cliff
[Previous turn undone.]

* * *

>w
I couldn't go that way.

Turn Count: 64
FoundClues: 5

>e
Bottom of Cliff
I stood on a ridge densely packed with trees some ways below the highway. My wrecked car sat a few feet away. The ridge extended as far as I could see to the north, going nowhere in particular. To the west I saw the steep incline the car had rolled down, and the path it'd cut through the snow and brush.

My Toyota Corolla in a fetching "Regatta Blue" that must have looked appealing under bright dealership lights when it was brand new back in 1990. I wouldn't know. It now sat on its side like a beached whale, exactly where I'd left it. The key was still in the ignition.

Turn Count: 65
FoundClues: 5

>w
Sharp Bend
I walked on the snowy road about a hundred feet from the hairpin turn where my car had gone over; I could see the tire tracks and broken guardrail to the east.

A Mercedes is quietly idling here, V8 purring.

I could also see Val_SecondInv_TODO here.

Turn Count: 66
FoundClues: 5

>e
Bottom of Cliff
I stood on a ridge densely packed with trees some ways below the highway. My wrecked car sat a few feet away. The ridge extended as far as I could see to the north, going nowhere in particular. To the west I saw the steep incline the car had rolled down, and the path it'd cut through the snow and brush.

My Toyota Corolla in a fetching "Regatta Blue" that must have looked appealing under bright dealership lights when it was brand new back in 1990. I wouldn't know. It now sat on its side like a beached whale, exactly where I'd left it. The key was still in the ignition.

Turn Count: 67
FoundClues: 5

>w
Sharp Bend
I walked on the snowy road about a hundred feet from the hairpin turn where my car had gone over; I could see the tire tracks and broken guardrail to the east.

A Mercedes is quietly idling here, V8 purring.

I could also see Val_SecondInv_TODO here.

Turn Count: 68
FoundClues: 5

>look
Sharp Bend
I walked on the snowy road about a hundred feet from the hairpin turn where my car had gone over; I could see the tire tracks and broken guardrail to the east.

A Mercedes is quietly idling here, V8 purring.

I could also see Val_SecondInv_TODO here.

Turn Count: 69
FoundClues: 5

>e
Bottom of Cliff
I stood on a ridge densely packed with trees some ways below the highway. My wrecked car sat a few feet away. The ridge extended as far as I could see to the north, going nowhere in particular. To the west I saw the steep incline the car had rolled down, and the path it'd cut through the snow and brush.

My Toyota Corolla in a fetching "Regatta Blue" that must have looked appealing under bright dealership lights when it was brand new back in 1990. I wouldn't know. It now sat on its side like a beached whale, exactly where I'd left it. The key was still in the ignition.

Turn Count: 70
FoundClues: 5

>open door
I couldn't see any such thing.

>look
Bottom of Cliff
I stood on a ridge densely packed with trees some ways below the highway. My wrecked car sat a few feet away. The ridge extended as far as I could see to the north, going nowhere in particular. To the west I saw the steep incline the car had rolled down, and the path it'd cut through the snow and brush.

My Toyota Corolla in a fetching "Regatta Blue" that must have looked appealing under bright dealership lights when it was brand new back in 1990. I wouldn't know. It now sat on its side like a beached whale, exactly where I'd left it. The key was still in the ignition.

Turn Count: 71
FoundClues: 5

>w
Sharp Bend
I walked on the snowy road about a hundred feet from the hairpin turn where my car had gone over; I could see the tire tracks and broken guardrail to the east.

A Mercedes is quietly idling here, V8 purring.

I could also see Val_SecondInv_TODO here.

Turn Count: 72
FoundClues: 5

>e
Bottom of Cliff
I stood on a ridge densely packed with trees some ways below the highway. My wrecked car sat a few feet away. The ridge extended as far as I could see to the north, going nowhere in particular. To the west I saw the steep incline the car had rolled down, and the path it'd cut through the snow and brush.

My Toyota Corolla in a fetching "Regatta Blue" that must have looked appealing under bright dealership lights when it was brand new back in 1990. I wouldn't know. It now sat on its side like a beached whale, exactly where I'd left it. The key was still in the ignition.

Turn Count: 73
FoundClues: 5

>e
I couldn't go that way.

Turn Count: 74
FoundClues: 5

>x car
The car I'd driven for close to the last hundred thousand miles, fender bent and windshield missing. I hadn't expected to have to look at it again, but if Val thought there was something here, that's the hunch I was going to play.

If I was going to find anything, I'd have to look through it piece by piece to figure out what happened. I started to feel detached from the place, like I'd never been there before. Start fresh, don't miss anything. I told myself to treat it like any other crime scene.

Turn Count: 75
FoundClues: 5

>turn on car
I leaned into the cabin through the hole left by the windshield and turned the key. The headlights flicked on, and the dashboard lit up. I heard the radio bleat into the empty forest, muffled by the dull roar of air pouring out of the A/C vents. The engine turned over but didn't start. The inertia switch had cut off fuel to the engine when the car rolled down the hill. I didn't really mind, I hadn't planned on driving it out of here.

Turn Count: 76
FoundClues: 5

>x dashboard
I scanned the panel, and saw a red indicator I'd never seen lit before. The brake light.

Turn Count: 77
FoundClues: 5

>x brakes
I put a hand behind the wheel and the suspension arm and felt along the metal tube of the brake line, nearly slicing my finger on a thin slit. It wasn't a bit of rust or metal fatigue, the cut was too clean. It might have been made by a dremel or a wire cutter. Cutting brake lines straight through would stop the front brakes from working. But a leak like this could take hours to affect performance. Whatever my state of mind or driving had been on that turn, this wasn't an accident.

The fact that I was able to see all of this without a flashlight barely registered.

Turn Count: 78
FoundClues: 6

>w
Sharp Bend
I walked on the snowy road about a hundred feet from the hairpin turn where my car had gone over; I could see the tire tracks and broken guardrail to the east.

A Mercedes is quietly idling here, V8 purring.

I could also see Val_SecondInv_TODO here.

Turn Count: 79
FoundClues: 6

>enter car
Driveway
We stood at the end of a long gravel drive, staring up at a large house with a dark red wood exterior. Steps to the east led to a porch that spanned the facade of the place, wrapping around to a deck in the back that presumably had a great view of the lake and the countryside. It was more ski lodge than cabin, and looked like it could comfortably shelter an entire biathlon team if it had to.

Val's Mercedes was parked to one side of the driveway.

I could also see Val_SecondInv_TODO here.

Turn Count: 80
FoundClues: 6

>e
Front Porch
Steps led up from the gravel driveway to the porch. Narrow unpainted wood planks extended the length of the house, along with windows that looked into rooms at the front of the house. Through them, I saw blinds, and a glint of something metallic, like a shutter.

The front door stood open.

There was something about the door that looked like a B&E job.

Turn Count: 81
FoundClues: 6

>e
I walked into the house, taking care to close the door behind me.

Foyer
I walked into the spacious foyer, trying not to walk into the large lacquered wood screens in front of the door. The shiny black surfaces were decorated with an intricate picture in gold paint, depicting a Chinese court scene. It seemed at odds with the exterior of the house, but matched the rest of the decor; the interior was a mixture of Old World furniture and Asian influences. 

There was something about the door that looked like a B&E job.

Foyer
I walked into the spacious foyer, trying not to walk into the large lacquered wood screens in front of the door. The shiny black surfaces were decorated with an intricate picture in gold paint, depicting a Chinese court scene. It seemed at odds with the exterior of the house, but matched the rest of the decor; the interior was a mixture of Old World furniture and Asian influences. 

There was something about the door that looked like a B&E job.

Turn Count: 82
FoundClues: 6

>scenes
Scene 'Entire Game' playing (for 82 mins now)
Scene 'Mountain_Driving' ended
Scene 'Car_Escape' ended
Scene 'Cliff_Climbing' ended
Scene 'Car_Embarking' ended
Scene 'Riding_Scene' ended
Scene 'Body_Discovery' ended
Scene 'Prearrival' ended
Scene 'Guest_Arrival' ended
Scene 'First_Investigation' ended
Scene 'First_Sleep' ended
Scene 'Wakeup' ended
Scene 'Interrogation' ended
Scene 'Second_Investigation' ended
Scene 'GettingBopped' playing (for 1 mins now)
(Scene monitoring now switched on. Type "scenes off" to switch it off again.)

>scope
1: myself (847169)
2: a front door (848257)
3: lock_dummyobj (848321)
4: a cell phone (847201)

>showobj brake line
That noun did not make sense in this context.

>purloin brake line
[Can't move brake line: it's part of my car.]

>purloin car
Which do you mean, Upturned Car, the Mercedes, about her car or my car?

>showme brake line
brake line - clue
location: part of my car in Bottom of Cliff
singular-named, improper-named, unmarked for special listing; unlit, inedible, fixed in place, scenery, seen, familiar, examined, unbroken
list grouping key: none
printed name: "brake line"
printed plural name: "clues"
indefinite article: none
summary: none
description: "I put a hand behind the wheel and the suspension arm and felt along the metal tube of the brake line, nearly slicing my finger on a thin slit. It wasn't a bit of rust or metal fatigue, the cut was too clean. It might have been made by a dremel or a wire cutter. Cutting brake lines straight through would stop the front brakes from working. But a leak like this could take hours to affect performance. Whatever my state of mind or driving had been on that turn, this wasn't an accident.

The fact that I was able to see all of this without a flashlight barely registered."
initial appearance: none

>look
Foyer
I walked into the spacious foyer, trying not to walk into the large lacquered wood screens in front of the door. The shiny black surfaces were decorated with an intricate picture in gold paint, depicting a Chinese court scene. It seemed at odds with the exterior of the house, but matched the rest of the decor; the interior was a mixture of Old World furniture and Asian influences. 

There was something about the door that looked like a B&E job.

Turn Count: 83
FoundClues: 6

>scenes
Scene 'Entire Game' playing (for 83 mins now)
Scene 'Mountain_Driving' ended
Scene 'Car_Escape' ended
Scene 'Cliff_Climbing' ended
Scene 'Car_Embarking' ended
Scene 'Riding_Scene' ended
Scene 'Body_Discovery' ended
Scene 'Prearrival' ended
Scene 'Guest_Arrival' ended
Scene 'First_Investigation' ended
Scene 'First_Sleep' ended
Scene 'Wakeup' ended
Scene 'Interrogation' ended
Scene 'Second_Investigation' ended
Scene 'GettingBopped' playing (for 2 mins now)
(Scene monitoring now switched on. Type "scenes off" to switch it off again.)

>w
(first opening the front door)

Front Porch
Steps led up from the gravel driveway to the porch. Narrow unpainted wood planks extended the length of the house, along with windows that looked into rooms at the front of the house. Through them, I saw blinds, and a glint of something metallic, like a shutter.

The front door stood open.

There was something about the door that looked like a B&E job.

Turn Count: 84
FoundClues: 6

>e
Foyer
I walked into the spacious foyer, trying not to walk into the large lacquered wood screens in front of the door. The shiny black surfaces were decorated with an intricate picture in gold paint, depicting a Chinese court scene. It seemed at odds with the exterior of the house, but matched the rest of the decor; the interior was a mixture of Old World furniture and Asian influences. 

The front door stood open.

There was something about the door that looked like a B&E job.

Turn Count: 85
FoundClues: 6

* * *

I beg your pardon?

>look
Sharp Bend
I walked on the snowy road about a hundred feet from the hairpin turn where my car had gone over; I could see the tire tracks and broken guardrail to the east.

A Mercedes is quietly idling here, V8 purring.

I could also see Val_SecondInv_TODO here.

Turn Count: 64
FoundClues: 5

>n
I couldn't go that way.

Turn Count: 65
FoundClues: 5

>s
There was nothing interesting that way except for Manhattan, and it was a little far to walk.

Turn Count: 66
FoundClues: 5

>w
I couldn't go that way.

Turn Count: 67
FoundClues: 5

>e
I couldn't go that way.

Turn Count: 68
FoundClues: 5

>exits
south to Hairpin Turn and down to Bottom of Cliff
Turn Count: 69
FoundClues: 5

>n
I couldn't go that way.

Turn Count: 70
FoundClues: 5

>n
I couldn't go that way.

Turn Count: 71
FoundClues: 5

>look
Sharp Bend
I walked on the snowy road about a hundred feet from the hairpin turn where my car had gone over; I could see the tire tracks and broken guardrail to the east.

A Mercedes is quietly idling here, V8 purring.

I could also see Val_SecondInv_TODO here.

Turn Count: 72
FoundClues: 5

>w
I couldn't go that way.

Turn Count: 73
FoundClues: 5

>enter car
Driveway
We stood at the end of a long gravel drive, staring up at a large house with a dark red wood exterior. Steps to the east led to a porch that spanned the facade of the place, wrapping around to a deck in the back that presumably had a great view of the lake and the countryside. It was more ski lodge than cabin, and looked like it could comfortably shelter an entire biathlon team if it had to.

Val's Mercedes was parked to one side of the driveway.

I could also see Val_SecondInv_TODO here.

Turn Count: 74
FoundClues: 5

>enter mercedes
Sharp Bend
I walked on the snowy road about a hundred feet from the hairpin turn where my car had gone over; I could see the tire tracks and broken guardrail to the east.

A Mercedes is quietly idling here, V8 purring.

I could also see Val_SecondInv_TODO here.

Turn Count: 75
FoundClues: 5

>s
There was nothing interesting that way except for Manhattan, and it was a little far to walk.

Turn Count: 76
FoundClues: 5

>d
Bottom of Cliff
I stood on a ridge densely packed with trees some ways below the highway. My overturned car sat a few feet away. The ridge extended as far as I could see to the north, going nowhere in particular. To the west I saw the steep incline the car had rolled down, and the path it'd cut through the snow and brush.

Turn Count: 77
FoundClues: 5

>x car
I couldn't see any such thing.

>d
I couldn't go that way.

Turn Count: 78
FoundClues: 5

>w
Sharp Bend
I walked on the snowy road about a hundred feet from the hairpin turn where my car had gone over; I could see the tire tracks and broken guardrail to the east.

A Mercedes is quietly idling here, V8 purring.

I could also see Val_SecondInv_TODO here.

Turn Count: 79
FoundClues: 5

>s
There was nothing interesting that way except for Manhattan, and it was a little far to walk.

Turn Count: 80
FoundClues: 5

>e
I couldn't go that way.

Turn Count: 81
FoundClues: 5

>d
Bottom of Cliff
I stood on a ridge densely packed with trees some ways below the highway. My overturned car sat a few feet away. The ridge extended as far as I could see to the north, going nowhere in particular. To the west I saw the steep incline the car had rolled down, and the path it'd cut through the snow and brush.

Turn Count: 82
FoundClues: 5

>w
Sharp Bend
I walked on the snowy road about a hundred feet from the hairpin turn where my car had gone over; I could see the tire tracks and broken guardrail to the east.

A Mercedes is quietly idling here, V8 purring.

I could also see Val_SecondInv_TODO here.

Turn Count: 83
FoundClues: 5

>d
Bottom of Cliff
I stood on a ridge densely packed with trees some ways below the highway. My overturned car sat a few feet away. The ridge extended as far as I could see to the north, going nowhere in particular. To the west I saw the steep incline the car had rolled down, and the path it'd cut through the snow and brush.

Turn Count: 84
FoundClues: 5

>u
Sharp Bend
I walked on the snowy road about a hundred feet from the hairpin turn where my car had gone over; I could see the tire tracks and broken guardrail to the east.

A Mercedes is quietly idling here, V8 purring.

I could also see Val_SecondInv_TODO here.

Turn Count: 85
FoundClues: 5

>e
I couldn't go that way.

Turn Count: 86
FoundClues: 5

>s
There was nothing interesting that way except for Manhattan, and it was a little far to walk.

Turn Count: 87
FoundClues: 5

>d
Bottom of Cliff
I stood on a ridge densely packed with trees some ways below the highway. My overturned car sat a few feet away. The ridge extended as far as I could see to the north, going nowhere in particular. To the west I saw the steep incline the car had rolled down, and the path it'd cut through the snow and brush.

Turn Count: 88
FoundClues: 5

>exits
north and up to Sharp Bend
Turn Count: 89
FoundClues: 5

>u
Sharp Bend
I walked on the snowy road about a hundred feet from the hairpin turn where my car had gone over; I could see the tire tracks and broken guardrail to the east.

A Mercedes is quietly idling here, V8 purring.

I could also see Val_SecondInv_TODO here.

Turn Count: 90
FoundClues: 5

>exits
south to Hairpin Turn and down to Bottom of Cliff
Turn Count: 91
FoundClues: 5

>s
There was nothing interesting that way except for Manhattan, and it was a little far to walk.

Turn Count: 92
FoundClues: 5

>d
Bottom of Cliff
I stood on a ridge densely packed with trees some ways below the highway. My overturned car sat a few feet away. The ridge extended as far as I could see to the north, going nowhere in particular. To the west I saw the steep incline the car had rolled down, and the path it'd cut through the snow and brush.

Turn Count: 93
FoundClues: 5

>n
Mountain Ridge
I had a bad feeling as I walked my way along the ridge, trudging a couple of miles through the foot-deep snow. The path didn't seem to be leading anywhere, and the sky kept getting lighter as I went. I still had enough time to turn back, if I wanted.

Turn Count: 94
FoundClues: 5

>n
Dense Forest
I walked for what must have been half an hour through the pines, which kept getting denser. In the light just before dawn, I saw the evergreen foliage come to a sudden stop ahead. I was starting to get seriously worried.

Turn Count: 95
FoundClues: 5

>n
Precipice
The forest abruptly ended in the edge of a cliff, overlooking a valley and several lakes hundreds of feet below.

Turn Count: 96
FoundClues: 5

>undo
Dense Forest
[Previous turn undone.]

* * *

>undo
Bottom of Cliff
[Previous turn undone.]

>s
I couldn't go that way.

Turn Count: 94
FoundClues: 5

>n
Mountain Ridge
I had a bad feeling as I walked my way along the ridge, trudging a couple of miles through the foot-deep snow. The path didn't seem to be leading anywhere, and the sky kept getting lighter as I went. I still had enough time to turn back, if I wanted.

Turn Count: 95
FoundClues: 5

>n
Dense Forest
I walked for what must have been half an hour through the pines, which kept getting denser. In the light just before dawn, I saw the evergreen foliage come to a sudden stop ahead. I was starting to get seriously worried.

Turn Count: 96
FoundClues: 5

>n
Precipice
The forest abruptly ended in the edge of a cliff, overlooking a valley and several lakes hundreds of feet below.

Turn Count: 97
FoundClues: 5

>s
Dense Forest
I walked for what must have been half an hour through the pines, which kept getting denser. In the light just before dawn, I saw the evergreen foliage come to a sudden stop ahead. I was starting to get seriously worried.

Turn Count: 98
FoundClues: 5

>test
>--> The following tests are available:
'test firstconvo'
'test sunrise_lose'
'test discover'
'test body'
'test arrival'
'test myclues'
'test valinvest'
'test janinv'
'test master'
'test computer'
'test bedtime'
'test vdet'
'test cartrip'
'test me'

>s
Mountain Ridge
I had a bad feeling as I walked my way along the ridge, trudging a couple of miles through the foot-deep snow. The path didn't seem to be leading anywhere, and the sky kept getting lighter as I went. I still had enough time to turn back, if I wanted.

Turn Count: 99
FoundClues: 5

>s
Bottom of Cliff
I stood on a ridge densely packed with trees some ways below the highway. My overturned car sat a few feet away. The ridge extended as far as I could see to the north, going nowhere in particular. To the west I saw the steep incline the car had rolled down, and the path it'd cut through the snow and brush.

Turn Count: 100
FoundClues: 5

>x car
I couldn't see any such thing.

* * *

>scenes
Scene 'Entire Game' playing (for 63 mins now)
Scene 'Mountain_Driving' ended
Scene 'Car_Escape' ended
Scene 'Cliff_Climbing' ended
Scene 'Car_Embarking' ended
Scene 'Riding_Scene' ended
Scene 'Body_Discovery' ended
Scene 'Prearrival' ended
Scene 'Guest_Arrival' ended
Scene 'First_Investigation' ended
Scene 'First_Sleep' ended
Scene 'Wakeup' ended
Scene 'Interrogation' ended
Scene 'Second_Investigation' playing (for 6 mins now)
(Scene monitoring now switched on. Type "scenes off" to switch it off again.)

>look
Sharp Bend
I walked on the snowy road about a hundred feet from the hairpin turn where my car had gone over; I could see the tire tracks and broken guardrail to the east.

A Mercedes is quietly idling here, V8 purring.

I could also see Val_SecondInv_TODO here.

Turn Count: 64
FoundClues: 5

>w
I couldn't go that way.

Turn Count: 65
FoundClues: 5

>e
Bottom of Cliff
I stood on a ridge densely packed with trees some ways below the highway. My wrecked car sat a few feet away. The ridge extended as far as I could see to the north, going nowhere in particular. To the west I saw the steep incline the car had rolled down, and the path it'd cut through the snow and brush.

My Toyota Corolla in a fetching "Regatta Blue" that must have looked appealing under bright dealership lights when it was brand new back in 1990. I wouldn't know. It now sat on its side like a beached whale, exactly where I'd left it. The key was still in the ignition.

Turn Count: 66
FoundClues: 5

>w
Sharp Bend
I walked on the snowy road about a hundred feet from the hairpin turn where my car had gone over; I could see the tire tracks and broken guardrail to the east.

A Mercedes is quietly idling here, V8 purring.

I could also see Val_SecondInv_TODO here.

Turn Count: 67
FoundClues: 5

>e
Bottom of Cliff
I stood on a ridge densely packed with trees some ways below the highway. My wrecked car sat a few feet away. The ridge extended as far as I could see to the north, going nowhere in particular. To the west I saw the steep incline the car had rolled down, and the path it'd cut through the snow and brush.

My Toyota Corolla in a fetching "Regatta Blue" that must have looked appealing under bright dealership lights when it was brand new back in 1990. I wouldn't know. It now sat on its side like a beached whale, exactly where I'd left it. The key was still in the ignition.

Turn Count: 68
FoundClues: 5

>close door
I couldn't see any such thing.

>w
Sharp Bend
I walked on the snowy road about a hundred feet from the hairpin turn where my car had gone over; I could see the tire tracks and broken guardrail to the east.

A Mercedes is quietly idling here, V8 purring.

I could also see Val_SecondInv_TODO here.

Turn Count: 69
FoundClues: 5

>e
Bottom of Cliff
I stood on a ridge densely packed with trees some ways below the highway. My wrecked car sat a few feet away. The ridge extended as far as I could see to the north, going nowhere in particular. To the west I saw the steep incline the car had rolled down, and the path it'd cut through the snow and brush.

My Toyota Corolla in a fetching "Regatta Blue" that must have looked appealing under bright dealership lights when it was brand new back in 1990. I wouldn't know. It now sat on its side like a beached whale, exactly where I'd left it. The key was still in the ignition.

Turn Count: 70
FoundClues: 5

>w
Sharp Bend
I walked on the snowy road about a hundred feet from the hairpin turn where my car had gone over; I could see the tire tracks and broken guardrail to the east.

A Mercedes is quietly idling here, V8 purring.

I could also see Val_SecondInv_TODO here.

Turn Count: 71
FoundClues: 5

>e
Bottom of Cliff
I stood on a ridge densely packed with trees some ways below the highway. My wrecked car sat a few feet away. The ridge extended as far as I could see to the north, going nowhere in particular. To the west I saw the steep incline the car had rolled down, and the path it'd cut through the snow and brush.

My Toyota Corolla in a fetching "Regatta Blue" that must have looked appealing under bright dealership lights when it was brand new back in 1990. I wouldn't know. It now sat on its side like a beached whale, exactly where I'd left it. The key was still in the ignition.

Turn Count: 72
FoundClues: 5

>w
Sharp Bend
I walked on the snowy road about a hundred feet from the hairpin turn where my car had gone over; I could see the tire tracks and broken guardrail to the east.

A Mercedes is quietly idling here, V8 purring.

I could also see Val_SecondInv_TODO here.

Turn Count: 73
FoundClues: 5

>look
Sharp Bend
I walked on the snowy road about a hundred feet from the hairpin turn where my car had gone over; I could see the tire tracks and broken guardrail to the east.

A Mercedes is quietly idling here, V8 purring.

I could also see Val_SecondInv_TODO here.

Turn Count: 74
FoundClues: 5

>e
Bottom of Cliff
I stood on a ridge densely packed with trees some ways below the highway. My wrecked car sat a few feet away. The ridge extended as far as I could see to the north, going nowhere in particular. To the west I saw the steep incline the car had rolled down, and the path it'd cut through the snow and brush.

My Toyota Corolla in a fetching "Regatta Blue" that must have looked appealing under bright dealership lights when it was brand new back in 1990. I wouldn't know. It now sat on its side like a beached whale, exactly where I'd left it. The key was still in the ignition.

Turn Count: 75
FoundClues: 5

>open door
I couldn't see any such thing.

>look
Bottom of Cliff
I stood on a ridge densely packed with trees some ways below the highway. My wrecked car sat a few feet away. The ridge extended as far as I could see to the north, going nowhere in particular. To the west I saw the steep incline the car had rolled down, and the path it'd cut through the snow and brush.

My Toyota Corolla in a fetching "Regatta Blue" that must have looked appealing under bright dealership lights when it was brand new back in 1990. I wouldn't know. It now sat on its side like a beached whale, exactly where I'd left it. The key was still in the ignition.

Turn Count: 76
FoundClues: 5

>w
Sharp Bend
I walked on the snowy road about a hundred feet from the hairpin turn where my car had gone over; I could see the tire tracks and broken guardrail to the east.

A Mercedes is quietly idling here, V8 purring.

I could also see Val_SecondInv_TODO here.

Turn Count: 77
FoundClues: 5

>e
Bottom of Cliff
I stood on a ridge densely packed with trees some ways below the highway. My wrecked car sat a few feet away. The ridge extended as far as I could see to the north, going nowhere in particular. To the west I saw the steep incline the car had rolled down, and the path it'd cut through the snow and brush.

My Toyota Corolla in a fetching "Regatta Blue" that must have looked appealing under bright dealership lights when it was brand new back in 1990. I wouldn't know. It now sat on its side like a beached whale, exactly where I'd left it. The key was still in the ignition.

Turn Count: 78
FoundClues: 5

>e
I couldn't go that way.

Turn Count: 79
FoundClues: 5

>x car
The car I'd driven for close to the last hundred thousand miles, fender bent and windshield missing. I hadn't expected to have to look at it again, but if Val thought there was something here, that's the hunch I was going to play.

If I was going to find anything, I'd have to look through it piece by piece to figure out what happened. I started to feel detached from the place, like I'd never been there before. Start fresh, don't miss anything. I told myself to treat it like any other crime scene.

Turn Count: 80
FoundClues: 5

>turn on car
I leaned into the cabin through the hole left by the windshield and turned the key. The headlights flicked on, and the dashboard lit up. I heard the radio bleat into the empty forest, muffled by the dull roar of air pouring out of the A/C vents. The engine turned over but didn't start. The inertia switch had cut off fuel to the engine when the car rolled down the hill. I didn't really mind, I hadn't planned on driving it out of here.

Turn Count: 81
FoundClues: 5

>x dashboard
I scanned the panel, and saw a red indicator I'd never seen lit before. The brake light.

Turn Count: 82
FoundClues: 5

>x brakes
I put a hand behind the wheel and the suspension arm and felt along the metal tube of the brake line, nearly slicing my finger on a thin slit. It wasn't a bit of rust or metal fatigue, the cut was too clean. It might have been made by a dremel or a wire cutter. Cutting brake lines straight through would stop the front brakes from working. But a leak like this could take hours to affect performance. Whatever my state of mind or driving had been on that turn, this wasn't an accident.

The fact that I was able to see all of this without a flashlight barely registered.

Turn Count: 83
FoundClues: 6

>w
Sharp Bend
I walked on the snowy road about a hundred feet from the hairpin turn where my car had gone over; I could see the tire tracks and broken guardrail to the east.

A Mercedes is quietly idling here, V8 purring.

I could also see Val_SecondInv_TODO here.

Turn Count: 84
FoundClues: 6

>enter car
Driveway
We stood at the end of a long gravel drive, staring up at a large house with a dark red wood exterior. Steps to the east led to a porch that spanned the facade of the place, wrapping around to a deck in the back that presumably had a great view of the lake and the countryside. It was more ski lodge than cabin, and looked like it could comfortably shelter an entire biathlon team if it had to.

Val's Mercedes was parked to one side of the driveway.

I could also see Val_SecondInv_TODO here.

Turn Count: 85
FoundClues: 6

>e
Front Porch
Steps led up from the gravel driveway to the porch. Narrow unpainted wood planks extended the length of the house, along with windows that looked into rooms at the front of the house. Through them, I saw blinds, and a glint of something metallic, like a shutter.

The front door stood open.

There was something about the door that looked like a B&E job.

Turn Count: 86
FoundClues: 6

>e
I walked into the house, taking care to close the door behind me.

Foyer
I walked into the spacious foyer, trying not to walk into the large lacquered wood screens in front of the door. The shiny black surfaces were decorated with an intricate picture in gold paint, depicting a Chinese court scene. It seemed at odds with the exterior of the house, but matched the rest of the decor; the interior was a mixture of Old World furniture and Asian influences. 

There was something about the door that looked like a B&E job.

Foyer
I walked into the spacious foyer, trying not to walk into the large lacquered wood screens in front of the door. The shiny black surfaces were decorated with an intricate picture in gold paint, depicting a Chinese court scene. It seemed at odds with the exterior of the house, but matched the rest of the decor; the interior was a mixture of Old World furniture and Asian influences. 

There was something about the door that looked like a B&E job.

Turn Count: 87
FoundClues: 6

>scenes
Scene 'Entire Game' playing (for 87 mins now)
Scene 'Mountain_Driving' ended
Scene 'Car_Escape' ended
Scene 'Cliff_Climbing' ended
Scene 'Car_Embarking' ended
Scene 'Riding_Scene' ended
Scene 'Body_Discovery' ended
Scene 'Prearrival' ended
Scene 'Guest_Arrival' ended
Scene 'First_Investigation' ended
Scene 'First_Sleep' ended
Scene 'Wakeup' ended
Scene 'Interrogation' ended
Scene 'Second_Investigation' playing (for 30 mins now)
(Scene monitoring now switched on. Type "scenes off" to switch it off again.)

>scope
1: myself (847094)
2: a front door (848182)
3: lock_dummyobj (848246)
4: a cell phone (847126)

>showobj brake line
That noun did not make sense in this context.

* * *

>look
Foyer
I walked into the spacious foyer, trying not to walk into the large lacquered wood screens in front of the door. The shiny black surfaces were decorated with an intricate picture in gold paint, depicting a Chinese court scene. It seemed at odds with the exterior of the house, but matched the rest of the decor; the interior was a mixture of Old World furniture and Asian influences. 

There was something about the door that looked like a B&E job.

Turn Count: 88
FoundClues: 6

>scenes
Scene 'Entire Game' playing (for 88 mins now)
Scene 'Mountain_Driving' ended
Scene 'Car_Escape' ended
Scene 'Cliff_Climbing' ended
Scene 'Car_Embarking' ended
Scene 'Riding_Scene' ended
Scene 'Body_Discovery' ended
Scene 'Prearrival' ended
Scene 'Guest_Arrival' ended
Scene 'First_Investigation' ended
Scene 'First_Sleep' ended
Scene 'Wakeup' ended
Scene 'Interrogation' ended
Scene 'Second_Investigation' playing (for 31 mins now)
(Scene monitoring now switched on. Type "scenes off" to switch it off again.)

* * *

>look
Sharp Bend
I walked on the snowy road about a hundred feet from the hairpin turn where my car had gone over; I could see the tire tracks and broken guardrail to the east.

A Mercedes is quietly idling here, V8 purring.

I could also see Val_SecondInv_TODO here.

Turn Count: 64
FoundClues: 5

>get in car
Driveway
We stood at the end of a long gravel drive, staring up at a large house with a dark red wood exterior. Steps to the east led to a porch that spanned the facade of the place, wrapping around to a deck in the back that presumably had a great view of the lake and the countryside. It was more ski lodge than cabin, and looked like it could comfortably shelter an entire biathlon team if it had to.

Val's Mercedes was parked to one side of the driveway.

I could also see Val_SecondInv_TODO here.

Turn Count: 65
FoundClues: 5

I beg your pardon?

>e
Front Porch
Steps led up from the gravel driveway to the porch. Narrow unpainted wood planks extended the length of the house, along with windows that looked into rooms at the front of the house. Through them, I saw blinds, and a glint of something metallic, like a shutter.

The front door stood open.

There was something about the door that looked like a B&E job.

Turn Count: 66
FoundClues: 5

>x door
A large wooden door, painted white as a preacher's picket fence. It didn't have a window or peephole. Something seemed odd about the lock, like it had been damaged. There was splintered wood on the side of the doorframe where someone had apparently forced the door open.

Turn Count: 67
FoundClues: 5

>x lock
I could see obvious scratch marks at the deadbolt that could've been left by an intruder using a lockpick. Going by the state of the doorframe, the attempt hadn't been successful.

Turn Count: 68
FoundClues: 6

>e
Foyer
I walked into the spacious foyer, trying not to walk into the large lacquered wood screens in front of the door. The shiny black surfaces were decorated with an intricate picture in gold paint, depicting a Chinese court scene. It seemed at odds with the exterior of the house, but matched the rest of the decor; the interior was a mixture of Old World furniture and Asian influences. 

Foyer
I walked into the spacious foyer, trying not to walk into the large lacquered wood screens in front of the door. The shiny black surfaces were decorated with an intricate picture in gold paint, depicting a Chinese court scene. It seemed at odds with the exterior of the house, but matched the rest of the decor; the interior was a mixture of Old World furniture and Asian influences. 

Turn Count: 69
FoundClues: 6

>scenes
Scene 'Entire Game' playing (for 69 mins now)
Scene 'Mountain_Driving' ended
Scene 'Car_Escape' ended
Scene 'Cliff_Climbing' ended
Scene 'Car_Embarking' ended
Scene 'Riding_Scene' ended
Scene 'Body_Discovery' ended
Scene 'Prearrival' ended
Scene 'Guest_Arrival' ended
Scene 'First_Investigation' ended
Scene 'First_Sleep' ended
Scene 'Wakeup' ended
Scene 'Interrogation' ended
Scene 'Second_Investigation' playing (for 12 mins now)
(Scene monitoring now switched on. Type "scenes off" to switch it off again.)

>look
Foyer
I walked into the spacious foyer, trying not to walk into the large lacquered wood screens in front of the door. The shiny black surfaces were decorated with an intricate picture in gold paint, depicting a Chinese court scene. It seemed at odds with the exterior of the house, but matched the rest of the decor; the interior was a mixture of Old World furniture and Asian influences. 

Turn Count: 70
FoundClues: 6

>w
(first opening the front door)

Front Porch
Steps led up from the gravel driveway to the porch. Narrow unpainted wood planks extended the length of the house, along with windows that looked into rooms at the front of the house. Through them, I saw blinds, and a glint of something metallic, like a shutter.

The front door stood open.

Turn Count: 71
FoundClues: 6

>e
Foyer
I walked into the spacious foyer, trying not to walk into the large lacquered wood screens in front of the door. The shiny black surfaces were decorated with an intricate picture in gold paint, depicting a Chinese court scene. It seemed at odds with the exterior of the house, but matched the rest of the decor; the interior was a mixture of Old World furniture and Asian influences. 

Foyer
I walked into the spacious foyer, trying not to walk into the large lacquered wood screens in front of the door. The shiny black surfaces were decorated with an intricate picture in gold paint, depicting a Chinese court scene. It seemed at odds with the exterior of the house, but matched the rest of the decor; the interior was a mixture of Old World furniture and Asian influences. 

Turn Count: 72
FoundClues: 6

>w
(first opening the front door)

Front Porch
Steps led up from the gravel driveway to the porch. Narrow unpainted wood planks extended the length of the house, along with windows that looked into rooms at the front of the house. Through them, I saw blinds, and a glint of something metallic, like a shutter.

The front door stood open.

Turn Count: 73
FoundClues: 6

>e
Foyer
I walked into the spacious foyer, trying not to walk into the large lacquered wood screens in front of the door. The shiny black surfaces were decorated with an intricate picture in gold paint, depicting a Chinese court scene. It seemed at odds with the exterior of the house, but matched the rest of the decor; the interior was a mixture of Old World furniture and Asian influences. 

Foyer
I walked into the spacious foyer, trying not to walk into the large lacquered wood screens in front of the door. The shiny black surfaces were decorated with an intricate picture in gold paint, depicting a Chinese court scene. It seemed at odds with the exterior of the house, but matched the rest of the decor; the interior was a mixture of Old World furniture and Asian influences. 

Turn Count: 74
FoundClues: 6

>close door
That was already closed.

Turn Count: 75
FoundClues: 6

>w
(first opening the front door)

Front Porch
Steps led up from the gravel driveway to the porch. Narrow unpainted wood planks extended the length of the house, along with windows that looked into rooms at the front of the house. Through them, I saw blinds, and a glint of something metallic, like a shutter.

The front door stood open.

Turn Count: 76
FoundClues: 6

>e
Foyer
I walked into the spacious foyer, trying not to walk into the large lacquered wood screens in front of the door. The shiny black surfaces were decorated with an intricate picture in gold paint, depicting a Chinese court scene. It seemed at odds with the exterior of the house, but matched the rest of the decor; the interior was a mixture of Old World furniture and Asian influences. 

Foyer
I walked into the spacious foyer, trying not to walk into the large lacquered wood screens in front of the door. The shiny black surfaces were decorated with an intricate picture in gold paint, depicting a Chinese court scene. It seemed at odds with the exterior of the house, but matched the rest of the decor; the interior was a mixture of Old World furniture and Asian influences. 

Turn Count: 77
FoundClues: 6

>w
(first opening the front door)

Front Porch
Steps led up from the gravel driveway to the porch. Narrow unpainted wood planks extended the length of the house, along with windows that looked into rooms at the front of the house. Through them, I saw blinds, and a glint of something metallic, like a shutter.

The front door stood open.

Turn Count: 78
FoundClues: 6

>e
Foyer
I walked into the spacious foyer, trying not to walk into the large lacquered wood screens in front of the door. The shiny black surfaces were decorated with an intricate picture in gold paint, depicting a Chinese court scene. It seemed at odds with the exterior of the house, but matched the rest of the decor; the interior was a mixture of Old World furniture and Asian influences. 

Foyer
I walked into the spacious foyer, trying not to walk into the large lacquered wood screens in front of the door. The shiny black surfaces were decorated with an intricate picture in gold paint, depicting a Chinese court scene. It seemed at odds with the exterior of the house, but matched the rest of the decor; the interior was a mixture of Old World furniture and Asian influences. 

Turn Count: 79
FoundClues: 6

>w
(first opening the front door)

Front Porch
Steps led up from the gravel driveway to the porch. Narrow unpainted wood planks extended the length of the house, along with windows that looked into rooms at the front of the house. Through them, I saw blinds, and a glint of something metallic, like a shutter.

The front door stood open.

Turn Count: 80
FoundClues: 6

>look
Front Porch
Steps led up from the gravel driveway to the porch. Narrow unpainted wood planks extended the length of the house, along with windows that looked into rooms at the front of the house. Through them, I saw blinds, and a glint of something metallic, like a shutter.

The front door stood open.

Turn Count: 81
FoundClues: 6

>e
Foyer
I walked into the spacious foyer, trying not to walk into the large lacquered wood screens in front of the door. The shiny black surfaces were decorated with an intricate picture in gold paint, depicting a Chinese court scene. It seemed at odds with the exterior of the house, but matched the rest of the decor; the interior was a mixture of Old World furniture and Asian influences. 

Foyer
I walked into the spacious foyer, trying not to walk into the large lacquered wood screens in front of the door. The shiny black surfaces were decorated with an intricate picture in gold paint, depicting a Chinese court scene. It seemed at odds with the exterior of the house, but matched the rest of the decor; the interior was a mixture of Old World furniture and Asian influences. 

Turn Count: 82
FoundClues: 6

>open door
I opened the front door.

Turn Count: 83
FoundClues: 6

>look
Foyer
I walked into the spacious foyer, trying not to walk into the large lacquered wood screens in front of the door. The shiny black surfaces were decorated with an intricate picture in gold paint, depicting a Chinese court scene. It seemed at odds with the exterior of the house, but matched the rest of the decor; the interior was a mixture of Old World furniture and Asian influences. 

The front door stood open.

Turn Count: 84
FoundClues: 6

>w
Front Porch
Steps led up from the gravel driveway to the porch. Narrow unpainted wood planks extended the length of the house, along with windows that looked into rooms at the front of the house. Through them, I saw blinds, and a glint of something metallic, like a shutter.

The front door stood open.

Turn Count: 85
FoundClues: 6

>e
Foyer
I walked into the spacious foyer, trying not to walk into the large lacquered wood screens in front of the door. The shiny black surfaces were decorated with an intricate picture in gold paint, depicting a Chinese court scene. It seemed at odds with the exterior of the house, but matched the rest of the decor; the interior was a mixture of Old World furniture and Asian influences. 

Foyer
I walked into the spacious foyer, trying not to walk into the large lacquered wood screens in front of the door. The shiny black surfaces were decorated with an intricate picture in gold paint, depicting a Chinese court scene. It seemed at odds with the exterior of the house, but matched the rest of the decor; the interior was a mixture of Old World furniture and Asian influences. 

Turn Count: 86
FoundClues: 6

* * *

>save
Save failed.

* * *

>test
>--> The following tests are available:
'test firstconvo'
'test sunrise_lose'
'test discover'
'test body'
'test arrival'
'test myclues'
'test valinvest'
'test janinv'
'test master'
'test computer'
'test bedtime'
'test vdet'
'test cartrip'
'test gettinbopped'
'test me'

* * *

>d
I couldn't go that way.

Turn Count: 72
FoundClues: 6

>e
Greatroom
The greatroom was clearly where the occupants of the house were meant to spend the majority of their time. Tall, dark wooden rafters criscrossed the high ceiling, the exposed beams clearly meant to evoke a Swiss chalet.

A large set of sofas were arranged around a huge rug. A dark wine stain was conspicuous on the armrest, standing out on the white fabric. Everything in the room faced a gray slate fireplace. 

A small spiral staircase in the corner led up to a reading nook, which was open to the greatroom, separated by a wooden balustrade. Coming from somewhere up there I heard "O Come, All Ye Faithful" warbling from what sounded like an old radio.

I could see a broken wineglass and a glass shard here.

Turn Count: 73
FoundClues: 6

>s
I couldn't go that way.

Turn Count: 74
FoundClues: 6
Through the stillness of the house, I heard yelling upstairs. It started as a panicked cry of shock and surprise, but quickly turned to screams of agony. It went on, loud and incoherent, muffled by the wooden walls of the house, getting more raspy and strangled, like a pillow smothering a face. Then, just as suddenly, it stopped. I felt a lump in my stomach like a lead weight, and reached for a gun that wasn't there.
(press any key)

>s
I couldn't go that way.

Turn Count: 75
FoundClues: 6

>d
I couldn't go that way.

Turn Count: 76
FoundClues: 6

>scenes
Scene 'Entire Game' playing (for 76 mins now)
Scene 'Mountain_Driving' ended
Scene 'Car_Escape' ended
Scene 'Cliff_Climbing' ended
Scene 'Car_Embarking' ended
Scene 'Riding_Scene' ended
Scene 'Body_Discovery' ended
Scene 'Prearrival' ended
Scene 'Guest_Arrival' ended
Scene 'First_Investigation' ended
Scene 'First_Sleep' ended
Scene 'Wakeup' ended
Scene 'Interrogation' ended
Scene 'Second_Investigation' ended
Scene 'ComingBack' ended
Scene 'DiscoverDet' playing (for 2 mins now)
(Scene monitoring now switched on. Type "scenes off" to switch it off again.)

>look
Greatroom
The greatroom was clearly where the occupants of the house were meant to spend the majority of their time. Tall, dark wooden rafters criscrossed the high ceiling, the exposed beams clearly meant to evoke a Swiss chalet.

A large set of sofas were arranged around a huge rug. A dark wine stain was conspicuous on the armrest, standing out on the white fabric. Everything in the room faced a gray slate fireplace. 

A small spiral staircase in the corner led up to a reading nook, which was open to the greatroom, separated by a wooden balustrade. Coming from somewhere up there I heard "Hark, The Herald Angels Sing" warbling from what sounded like an old radio.

I could see a broken wineglass and a glass shard here.

Turn Count: 77
FoundClues: 6

>scenes
Scene 'Entire Game' playing (for 77 mins now)
Scene 'Mountain_Driving' ended
Scene 'Car_Escape' ended
Scene 'Cliff_Climbing' ended
Scene 'Car_Embarking' ended
Scene 'Riding_Scene' ended
Scene 'Body_Discovery' ended
Scene 'Prearrival' ended
Scene 'Guest_Arrival' ended
Scene 'First_Investigation' ended
Scene 'First_Sleep' ended
Scene 'Wakeup' ended
Scene 'Interrogation' ended
Scene 'Second_Investigation' ended
Scene 'ComingBack' ended
Scene 'DiscoverDet' playing (for 3 mins now)
(Scene monitoring now switched on. Type "scenes off" to switch it off again.)

>w
Foyer
I walked into the spacious foyer, trying not to walk into the large lacquered wood screens in front of the door. The shiny black surfaces were decorated with an intricate picture in gold paint, depicting a Chinese court scene. It seemed at odds with the exterior of the house, but matched the rest of the decor; the interior was a mixture of Old World furniture and Asian influences. 

There was something about the door that looked like a B&E job.

Turn Count: 78
FoundClues: 6

>n
I couldn't go that way.

Turn Count: 79
FoundClues: 6

>d
I couldn't go that way.

Turn Count: 80
FoundClues: 6

>u
I couldn't go that way.

Turn Count: 81
FoundClues: 6

>d
I couldn't go that way.

Turn Count: 82
FoundClues: 6

>scenes
Scene 'Entire Game' playing (for 82 mins now)
Scene 'Mountain_Driving' ended
Scene 'Car_Escape' ended
Scene 'Cliff_Climbing' ended
Scene 'Car_Embarking' ended
Scene 'Riding_Scene' ended
Scene 'Body_Discovery' ended
Scene 'Prearrival' ended
Scene 'Guest_Arrival' ended
Scene 'First_Investigation' ended
Scene 'First_Sleep' ended
Scene 'Wakeup' ended
Scene 'Interrogation' ended
Scene 'Second_Investigation' ended
Scene 'ComingBack' ended
Scene 'DiscoverDet' playing (for 8 mins now)
(Scene monitoring now switched on. Type "scenes off" to switch it off again.)

>u
I couldn't go that way.

Turn Count: 83
FoundClues: 6

>look
Foyer
I walked into the spacious foyer, trying not to walk into the large lacquered wood screens in front of the door. The shiny black surfaces were decorated with an intricate picture in gold paint, depicting a Chinese court scene. It seemed at odds with the exterior of the house, but matched the rest of the decor; the interior was a mixture of Old World furniture and Asian influences. 

There was something about the door that looked like a B&E job.

Turn Count: 84
FoundClues: 6

>e
Greatroom
The greatroom was clearly where the occupants of the house were meant to spend the majority of their time. Tall, dark wooden rafters criscrossed the high ceiling, the exposed beams clearly meant to evoke a Swiss chalet.

A large set of sofas were arranged around a huge rug. A dark wine stain was conspicuous on the armrest, standing out on the white fabric. Everything in the room faced a gray slate fireplace. 

A small spiral staircase in the corner led up to a reading nook, which was open to the greatroom, separated by a wooden balustrade. Coming from somewhere up there I heard "O Come, All Ye Faithful" warbling from what sounded like an old radio.

I could see a broken wineglass and a glass shard here.

Turn Count: 85
FoundClues: 6

>d
I couldn't go that way.

Turn Count: 86
FoundClues: 6

>d
I couldn't go that way.

Turn Count: 87
FoundClues: 6

>e
Downstairs Hallway
A long narrow corridor connected the entrance of the house with the bedrooms. Lights were recessed into the ceiling overhead, shining down onto the polished wood floor. Maybe some people liked this sterile modern crap, but it made the place look like an art gallery, as far as I was concerned. A couple of paintings even adorned the walls, so maybe that was the idea, and I was just uncultured.

Turn Count: 88
FoundClues: 6

>d
Wine Cellar
The second I walked into the dark wine cellar, recessed lights in the ceiling turned on, probably activated by a motion sensor. 

 A wine rack ran the perimeter of the room, holding enough bottles to supply a French restaurant. A few seemed to be missing here and there. A wooden chair sat in the corner.

[Scene 'DiscoverDet' ends]
I was so focused on trying to read the labels on the fuse box that I didn't notice the footsteps behind me. Maybe I wouldn't have anyway. I heard a dull crack and realized it was the sound of a heavy bottle hitting the back of my head. It was the last thing I remembered thinking about before the rush of unconsciousness. I was out before I hit the floor.
(press any key)[Scene 'CellarThink' begins]

Wine Cellar
The second I walked into the dark wine cellar, recessed lights in the ceiling turned on, probably activated by a motion sensor. 

 A wine rack ran the perimeter of the room, holding enough bottles to supply a French restaurant. A few seemed to be missing here and there. A wooden chair sat in the corner.

Turn Count: 89
FoundClues: 6

>look
Wine Cellar
I had a headache TODO

Turn Count: 90
FoundClues: 6

>i
I was carrying:
  a cell phone

Turn Count: 91
FoundClues: 6

>inv
I was carrying:
  a cell phone

Turn Count: 92
FoundClues: 6

* * *

>w
(first opening the front door)
It seemed to be locked.

Turn Count: 72
FoundClues: 6

>n
I couldn't go that way.

Turn Count: 73
FoundClues: 6

>look
Foyer
I walked into the spacious foyer, trying not to walk into the large lacquered wood screens in front of the door. The shiny black surfaces were decorated with an intricate picture in gold paint, depicting a Chinese court scene. It seemed at odds with the exterior of the house, but matched the rest of the decor; the interior was a mixture of Old World furniture and Asian influences. 

There was something about the door that looked like a B&E job.

Turn Count: 74
FoundClues: 6
Through the stillness of the house, I heard yelling upstairs. It started as a panicked cry of shock and surprise, but quickly turned to screams of agony. It went on, loud and incoherent, muffled by the wooden walls of the house, getting more raspy and strangled, like a pillow smothering a face. Then, just as suddenly, it stopped. I felt a lump in my stomach like a lead weight, and reached for a gun that wasn't there.
(press any key)

>w
(first opening the front door)
It seemed to be locked.

Turn Count: 75
FoundClues: 6

>e
Greatroom
The greatroom was clearly where the occupants of the house were meant to spend the majority of their time. Tall, dark wooden rafters criscrossed the high ceiling, the exposed beams clearly meant to evoke a Swiss chalet.

A large set of sofas were arranged around a huge rug. A dark wine stain was conspicuous on the armrest, standing out on the white fabric. Everything in the room faced a gray slate fireplace. 

A small spiral staircase in the corner led up to a reading nook, which was open to the greatroom, separated by a wooden balustrade. Coming from somewhere up there I heard "Angels We Have Heard on High" warbling from what sounded like an old radio.

I could see a broken wineglass and a glass shard here.

Turn Count: 76
FoundClues: 6

>s
I couldn't go that way.

Turn Count: 77
FoundClues: 6

>n
I couldn't go that way.

Turn Count: 78
FoundClues: 6

>e
Downstairs Hallway
A long narrow corridor connected the entrance of the house with the bedrooms. Lights were recessed into the ceiling overhead, shining down onto the polished wood floor. Maybe some people liked this sterile modern crap, but it made the place look like an art gallery, as far as I was concerned. A couple of paintings even adorned the walls, so maybe that was the idea, and I was just uncultured.

Turn Count: 79
FoundClues: 6

>w
Greatroom
The greatroom was clearly where the occupants of the house were meant to spend the majority of their time. Tall, dark wooden rafters criscrossed the high ceiling, the exposed beams clearly meant to evoke a Swiss chalet.

A large set of sofas were arranged around a huge rug. A dark wine stain was conspicuous on the armrest, standing out on the white fabric. Everything in the room faced a gray slate fireplace. 

A small spiral staircase in the corner led up to a reading nook, which was open to the greatroom, separated by a wooden balustrade. Coming from somewhere up there I heard "Angels We Have Heard on High" warbling from what sounded like an old radio.

I could see a broken wineglass and a glass shard here.

Turn Count: 80
FoundClues: 6

>look
Greatroom
The greatroom was clearly where the occupants of the house were meant to spend the majority of their time. Tall, dark wooden rafters criscrossed the high ceiling, the exposed beams clearly meant to evoke a Swiss chalet.

A large set of sofas were arranged around a huge rug. A dark wine stain was conspicuous on the armrest, standing out on the white fabric. Everything in the room faced a gray slate fireplace. 

A small spiral staircase in the corner led up to a reading nook, which was open to the greatroom, separated by a wooden balustrade. Coming from somewhere up there I heard "O Come, All Ye Faithful" warbling from what sounded like an old radio.

I could see a broken wineglass and a glass shard here.

Turn Count: 81
FoundClues: 6

>e
Downstairs Hallway
A long narrow corridor connected the entrance of the house with the bedrooms. Lights were recessed into the ceiling overhead, shining down onto the polished wood floor. Maybe some people liked this sterile modern crap, but it made the place look like an art gallery, as far as I was concerned. A couple of paintings even adorned the walls, so maybe that was the idea, and I was just uncultured.

Turn Count: 82
FoundClues: 6

>e
Kitchen
I stepped into a kitchen big enough for a game of football. Wooden cabinets and handsome tile in earth tones went from wall to wall. The quaint country look was somewhat ruined by the collection of modern stainless steel kitchen appliances. They were brand new and it looked like not one of them had been used. It figured, this didn't seem like the kind of place that had a cooking staff.

Turn Count: 83
FoundClues: 6

>s
I couldn't go that way.

Turn Count: 84
FoundClues: 6

>e
I couldn't go that way.

Turn Count: 85
FoundClues: 6

>n
I couldn't go that way.

Turn Count: 86
FoundClues: 6

>s
I couldn't go that way.

Turn Count: 87
FoundClues: 6

>e
I couldn't go that way.

Turn Count: 88
FoundClues: 6

>d
I couldn't go that way.

Turn Count: 89
FoundClues: 6

>w
Downstairs Hallway
A long narrow corridor connected the entrance of the house with the bedrooms. Lights were recessed into the ceiling overhead, shining down onto the polished wood floor. Maybe some people liked this sterile modern crap, but it made the place look like an art gallery, as far as I was concerned. A couple of paintings even adorned the walls, so maybe that was the idea, and I was just uncultured.

Turn Count: 90
FoundClues: 6

>d
Wine Cellar
The second I walked into the dark wine cellar, recessed lights in the ceiling turned on, probably activated by a motion sensor. 

 A wine rack ran the perimeter of the room, holding enough bottles to supply a French restaurant. A few seemed to be missing here and there. A wooden chair sat in the corner.

Turn Count: 91
FoundClues: 6

>s
I couldn't go that way.

Turn Count: 92
FoundClues: 6

>n
I couldn't go that way.

Turn Count: 93
FoundClues: 6

>w
I couldn't go that way.

Turn Count: 94
FoundClues: 6

>d
I couldn't go that way.

Turn Count: 95
FoundClues: 6

>e
I couldn't go that way.

Turn Count: 96
FoundClues: 6

>s
I couldn't go that way.

Turn Count: 97
FoundClues: 6

>w
I couldn't go that way.

Turn Count: 98
FoundClues: 6

>s
I couldn't go that way.

Turn Count: 99
FoundClues: 6

>d
I couldn't go that way.

Turn Count: 100
FoundClues: 6

>scenes
Scene 'Entire Game' playing (for 100 mins now)
Scene 'Mountain_Driving' ended
Scene 'Car_Escape' ended
Scene 'Cliff_Climbing' ended
Scene 'Car_Embarking' ended
Scene 'Riding_Scene' ended
Scene 'Body_Discovery' ended
Scene 'Prearrival' ended
Scene 'Guest_Arrival' ended
Scene 'First_Investigation' ended
Scene 'First_Sleep' ended
Scene 'Wakeup' ended
Scene 'Interrogation' ended
Scene 'Second_Investigation' ended
Scene 'ComingBack' ended
Scene 'DiscoverDet' playing (for 26 mins now)
(Scene monitoring now switched on. Type "scenes off" to switch it off again.)

>look
Wine Cellar
The second I walked into the dark wine cellar, recessed lights in the ceiling turned on, probably activated by a motion sensor. 

 A wine rack ran the perimeter of the room, holding enough bottles to supply a French restaurant. A few seemed to be missing here and there. A wooden chair sat in the corner.

Turn Count: 101
FoundClues: 6

* * *

>e
Greatroom
The greatroom was clearly where the occupants of the house were meant to spend the majority of their time. Tall, dark wooden rafters criscrossed the high ceiling, the exposed beams clearly meant to evoke a Swiss chalet.

A large set of sofas were arranged around a huge rug. A dark wine stain was conspicuous on the armrest, standing out on the white fabric. Everything in the room faced a gray slate fireplace. 

A small spiral staircase in the corner led up to a reading nook, which was open to the greatroom, separated by a wooden balustrade. Coming from somewhere up there I heard "Angels We Have Heard on High" warbling from what sounded like an old radio.

I could see a broken wineglass and a glass shard here.

Turn Count: 72
FoundClues: 6

>w
Foyer
I walked into the spacious foyer, trying not to walk into the large lacquered wood screens in front of the door. The shiny black surfaces were decorated with an intricate picture in gold paint, depicting a Chinese court scene. It seemed at odds with the exterior of the house, but matched the rest of the decor; the interior was a mixture of Old World furniture and Asian influences. 

There was something about the door that looked like a B&E job.

Turn Count: 73
FoundClues: 6

>look
Foyer
I walked into the spacious foyer, trying not to walk into the large lacquered wood screens in front of the door. The shiny black surfaces were decorated with an intricate picture in gold paint, depicting a Chinese court scene. It seemed at odds with the exterior of the house, but matched the rest of the decor; the interior was a mixture of Old World furniture and Asian influences. 

There was something about the door that looked like a B&E job.

Turn Count: 74
FoundClues: 6
Through the stillness of the house, I heard yelling upstairs. It started as a panicked cry of shock and surprise, but quickly turned to screams of agony. It went on, loud and incoherent, muffled by the wooden walls of the house, getting more raspy and strangled, like a pillow smothering a face. Then, just as suddenly, it stopped. I felt a lump in my stomach like a lead weight, and reached for a gun that wasn't there.
(press any key)

>e
Greatroom
The greatroom was clearly where the occupants of the house were meant to spend the majority of their time. Tall, dark wooden rafters criscrossed the high ceiling, the exposed beams clearly meant to evoke a Swiss chalet.

A large set of sofas were arranged around a huge rug. A dark wine stain was conspicuous on the armrest, standing out on the white fabric. Everything in the room faced a gray slate fireplace. 

A small spiral staircase in the corner led up to a reading nook, which was open to the greatroom, separated by a wooden balustrade. Coming from somewhere up there I heard "God Rest Ye Merry, Gentlemen" warbling from what sounded like an old radio.

I could see a broken wineglass and a glass shard here.

Turn Count: 75
FoundClues: 6

>s
I couldn't go that way.

Turn Count: 76
FoundClues: 6

>e
Downstairs Hallway
A long narrow corridor connected the entrance of the house with the bedrooms. Lights were recessed into the ceiling overhead, shining down onto the polished wood floor. Maybe some people liked this sterile modern crap, but it made the place look like an art gallery, as far as I was concerned. A couple of paintings even adorned the walls, so maybe that was the idea, and I was just uncultured.

Turn Count: 77
FoundClues: 6

>n
Office
Of all the rooms I'd seen in the house, this one looked the most lived in. It had the musty smell of old books mixed with stale coffee coming from several cups on the desk.

I could see a computer here.

Turn Count: 78
FoundClues: 6

>s
Downstairs Hallway
A long narrow corridor connected the entrance of the house with the bedrooms. Lights were recessed into the ceiling overhead, shining down onto the polished wood floor. Maybe some people liked this sterile modern crap, but it made the place look like an art gallery, as far as I was concerned. A couple of paintings even adorned the walls, so maybe that was the idea, and I was just uncultured.

Turn Count: 79
FoundClues: 6

>e
Kitchen
I stepped into a kitchen big enough for a game of football. Wooden cabinets and handsome tile in earth tones went from wall to wall. The quaint country look was somewhat ruined by the collection of modern stainless steel kitchen appliances. They were brand new and it looked like not one of them had been used. It figured, this didn't seem like the kind of place that had a cooking staff.

Turn Count: 80
FoundClues: 6

>d
I couldn't go that way.

Turn Count: 81
FoundClues: 6

>w
Downstairs Hallway
A long narrow corridor connected the entrance of the house with the bedrooms. Lights were recessed into the ceiling overhead, shining down onto the polished wood floor. Maybe some people liked this sterile modern crap, but it made the place look like an art gallery, as far as I was concerned. A couple of paintings even adorned the walls, so maybe that was the idea, and I was just uncultured.

Turn Count: 82
FoundClues: 6

>d
Wine Cellar
The second I walked into the dark wine cellar, recessed lights in the ceiling turned on, probably activated by a motion sensor. 

 A wine rack ran the perimeter of the room, holding enough bottles to supply a French restaurant. A few seemed to be missing here and there. A wooden chair sat in the corner.

Turn Count: 83
FoundClues: 6

>s
I couldn't go that way.

Turn Count: 84
FoundClues: 6

>n
I couldn't go that way.

Turn Count: 85
FoundClues: 6

>w
I couldn't go that way.

Turn Count: 86
FoundClues: 6

>d
I couldn't go that way.

Turn Count: 87
FoundClues: 6

>e
I couldn't go that way.

Turn Count: 88
FoundClues: 6

>s
I couldn't go that way.

Turn Count: 89
FoundClues: 6

>w
I couldn't go that way.

Turn Count: 90
FoundClues: 6

>s
I couldn't go that way.

Turn Count: 91
FoundClues: 6

>d
I couldn't go that way.

Turn Count: 92
FoundClues: 6

>scenes
Scene 'Entire Game' playing (for 92 mins now)
Scene 'Mountain_Driving' ended
Scene 'Car_Escape' ended
Scene 'Cliff_Climbing' ended
Scene 'Car_Embarking' ended
Scene 'Riding_Scene' ended
Scene 'Body_Discovery' ended
Scene 'Prearrival' ended
Scene 'Guest_Arrival' ended
Scene 'First_Investigation' ended
Scene 'First_Sleep' ended
Scene 'Wakeup' ended
Scene 'Interrogation' ended
Scene 'Second_Investigation' ended
Scene 'ComingBack' ended
Scene 'DiscoverDet' playing (for 18 mins now)
(Scene monitoring now switched on. Type "scenes off" to switch it off again.)

>look
Wine Cellar
The second I walked into the dark wine cellar, recessed lights in the ceiling turned on, probably activated by a motion sensor. 

 A wine rack ran the perimeter of the room, holding enough bottles to supply a French restaurant. A few seemed to be missing here and there. A wooden chair sat in the corner.

Turn Count: 93
FoundClues: 6

>scenes
Scene 'Entire Game' playing (for 93 mins now)
Scene 'Mountain_Driving' ended
Scene 'Car_Escape' ended
Scene 'Cliff_Climbing' ended
Scene 'Car_Embarking' ended
Scene 'Riding_Scene' ended
Scene 'Body_Discovery' ended
Scene 'Prearrival' ended
Scene 'Guest_Arrival' ended
Scene 'First_Investigation' ended
Scene 'First_Sleep' ended
Scene 'Wakeup' ended
Scene 'Interrogation' ended
Scene 'Second_Investigation' ended
Scene 'ComingBack' ended
Scene 'DiscoverDet' playing (for 19 mins now)
(Scene monitoring now switched on. Type "scenes off" to switch it off again.)

>w
I couldn't go that way.

Turn Count: 94
FoundClues: 6

>n
I couldn't go that way.

Turn Count: 95
FoundClues: 6

>d
I couldn't go that way.

Turn Count: 96
FoundClues: 6

>u
Downstairs Hallway
A long narrow corridor connected the entrance of the house with the bedrooms. Lights were recessed into the ceiling overhead, shining down onto the polished wood floor. Maybe some people liked this sterile modern crap, but it made the place look like an art gallery, as far as I was concerned. A couple of paintings even adorned the walls, so maybe that was the idea, and I was just uncultured.

Turn Count: 97
FoundClues: 6

>d
Wine Cellar
The second I walked into the dark wine cellar, recessed lights in the ceiling turned on, probably activated by a motion sensor. 

 A wine rack ran the perimeter of the room, holding enough bottles to supply a French restaurant. A few seemed to be missing here and there. A wooden chair sat in the corner.

Turn Count: 98
FoundClues: 6

* * *

>e
Downstairs Hallway
A long narrow corridor connected the entrance of the house with the bedrooms. Lights were recessed into the ceiling overhead, shining down onto the polished wood floor. Maybe some people liked this sterile modern crap, but it made the place look like an art gallery, as far as I was concerned. A couple of paintings even adorned the walls, so maybe that was the idea, and I was just uncultured.

Turn Count: 73
FoundClues: 6

>d
Wine Cellar
The second I walked into the dark wine cellar, recessed lights in the ceiling turned on, probably activated by a motion sensor. 

 A wine rack ran the perimeter of the room, holding enough bottles to supply a French restaurant. A few seemed to be missing here and there. A wooden chair sat in the corner.

Turn Count: 74
FoundClues: 6
Through the stillness of the house, I heard yelling upstairs. It started as a panicked cry of shock and surprise, but quickly turned to screams of agony. It went on, loud and incoherent, muffled by the wooden walls of the house, getting more raspy and strangled, like a pillow smothering a face. Then, just as suddenly, it stopped. I felt a lump in my stomach like a lead weight, and reached for a gun that wasn't there.
(press any key)
I was so focused on trying to read the labels on the fuse box that I didn't notice the footsteps behind me. Maybe I wouldn't have anyway. I heard a dull crack and realized it was the sound of a heavy bottle hitting the back of my head. It was the last thing I remembered thinking about before the rush of unconsciousness. I was out before I hit the floor.
(press any key)
Wine Cellar
I woke up with a headache like I'd kissed the Long Island Express goodnight. When I tried to put my hands up to feel the back of my head, I realized it was tied to the chair, along with my legs. He'd gotten the drop on me, that was for sure.

Well, I was in pretty deep now. I looked around the dark room. No one to talk to but myself.

>clues
Clues

broken wineglass
bottle of wine

stain on Greatroom sofa
wineglass

knife

>i
I was carrying:
  a cell phone

Turn Count: 75
FoundClues: 6

>clues
Clues

broken wineglass
bottle of wine

stain on Greatroom sofa
wineglass

knife

>clues
Clues

broken wineglass
bottle of wine

stain on Greatroom sofa
wineglass

knife

* * *

>scenes
Scene 'Entire Game' playing (for 71 mins now)
Scene 'Mountain_Driving' ended
Scene 'Car_Escape' ended
Scene 'Cliff_Climbing' ended
Scene 'Car_Embarking' ended
Scene 'Riding_Scene' ended
Scene 'Body_Discovery' ended
Scene 'Prearrival' ended
Scene 'Guest_Arrival' ended
Scene 'First_Investigation' ended
Scene 'First_Sleep' ended
Scene 'Wakeup' ended
Scene 'Interrogation' ended
Scene 'Second_Investigation' ended
Scene 'ComingBack' playing (for 1 mins now)
(Scene monitoring now switched on. Type "scenes off" to switch it off again.)

>look
Foyer
I walked into the spacious foyer, trying not to walk into the large lacquered wood screens in front of the door. The shiny black surfaces were decorated with an intricate picture in gold paint, depicting a Chinese court scene. It seemed at odds with the exterior of the house, but matched the rest of the decor; the interior was a mixture of Old World furniture and Asian influences. 

There was something about the door that looked like a B&E job.

Turn Count: 72
FoundClues: 6

>e
Greatroom
The greatroom was clearly where the occupants of the house were meant to spend the majority of their time. Tall, dark wooden rafters criscrossed the high ceiling, the exposed beams clearly meant to evoke a Swiss chalet.

A large set of sofas were arranged around a huge rug. A dark wine stain was conspicuous on the armrest, standing out on the white fabric. Everything in the room faced a gray slate fireplace. 

A small spiral staircase in the corner led up to a reading nook, which was open to the greatroom, separated by a wooden balustrade. Coming from somewhere up there I heard "Angels We Have Heard on High" warbling from what sounded like an old radio.

I could see a broken wineglass and a glass shard here.

Turn Count: 73
FoundClues: 6

>take all
broken wineglass: I had enough of a mess on my hands without taking this one with me, but kept it anyway. It told an interesting story.

Turn Count: 74
FoundClues: 6
[Scene 'DiscoverDet' begins]
Through the stillness of the house, I heard yelling upstairs. It started as a panicked cry of shock and surprise, but quickly turned to screams of agony. It went on, loud and incoherent, muffled by the wooden walls of the house, getting more raspy and strangled, like a pillow smothering a face. Then, just as suddenly, it stopped. I felt a lump in my stomach like a lead weight, and reached for a gun that wasn't there.
(press any key)[Scene 'ComingBack' ends]

>look
Greatroom
The greatroom was clearly where the occupants of the house were meant to spend the majority of their time. Tall, dark wooden rafters criscrossed the high ceiling, the exposed beams clearly meant to evoke a Swiss chalet.

A large set of sofas were arranged around a huge rug. A dark wine stain was conspicuous on the armrest, standing out on the white fabric. Everything in the room faced a gray slate fireplace. 

A small spiral staircase in the corner led up to a reading nook, which was open to the greatroom, separated by a wooden balustrade. Coming from somewhere up there I heard "God Rest Ye Merry, Gentlemen" warbling from what sounded like an old radio.

I could see a glass shard here.

Turn Count: 75
FoundClues: 6

>e
Downstairs Hallway
A long narrow corridor connected the entrance of the house with the bedrooms. Lights were recessed into the ceiling overhead, shining down onto the polished wood floor. Maybe some people liked this sterile modern crap, but it made the place look like an art gallery, as far as I was concerned. A couple of paintings even adorned the walls, so maybe that was the idea, and I was just uncultured.

Turn Count: 76
FoundClues: 6

>u
Upstairs Hallway
Turn Count: 77
FoundClues: 6

>w
I couldn't go that way.

Turn Count: 78
FoundClues: 6

>n
North Hallway
Turn Count: 79
FoundClues: 6

>look
North Hallway
Turn Count: 80
FoundClues: 6

>exits
north through master bedroom door (closed), south to Upstairs Hallway and west through bedroom door to the Bedroom
Turn Count: 81
FoundClues: 6

>w
Bedroom
I checked my watch, it was getting late, almost noon. I had a million things to think about, but figured I should get a few hours of sleep while I still could.

I could see a memo and a bottle of bourbon here.

Turn Count: 82
FoundClues: 6

>e
North Hallway
Turn Count: 83
FoundClues: 6

>s
Upstairs Hallway
Turn Count: 84
FoundClues: 6

>n
North Hallway
Turn Count: 85
FoundClues: 6

>e
I couldn't go that way.

Turn Count: 86
FoundClues: 6

>w
Bedroom
I checked my watch, it was getting late, almost noon. I had a million things to think about, but figured I should get a few hours of sleep while I still could.

I could see a memo and a bottle of bourbon here.

Turn Count: 87
FoundClues: 6

>look
Bedroom
I checked my watch, it was getting late, almost noon. I had a million things to think about, but figured I should get a few hours of sleep while I still could.

I could see a memo and a bottle of bourbon here.

Turn Count: 88
FoundClues: 6

>e
North Hallway
Turn Count: 89
FoundClues: 6

>e
I couldn't go that way.

Turn Count: 90
FoundClues: 6

>s
Upstairs Hallway
Turn Count: 91
FoundClues: 6

>e
East Hallway
Turn Count: 92
FoundClues: 6

>n
Hemlock Room
The room had an angled ceiling to give the impression of a cozy attic or country cabin, except it was about as big as my entire apartment. Piles of climbing equipment and bunched-up coils of rope were heaped in the corner on top of his luggage. A gray sweater hung on a chair, flecks of dark reddish-brown stains dried on it.

Jan stood here amid his piles climbing gear, coiling a long length of rope around one of his broad shoulders.

Turn Count: 93
FoundClues: 6

>s
East Hallway
Turn Count: 94
FoundClues: 6

>e
Oak Room
The room had a large white rug in the center, and a four-poster bed that looked nice enough that it might have once sat in the master bedroom. An ugly, expensive-looking valise lay on the bed, its weight sinking it a full six inches into the feathertop mattress.

I could see Nathaniel here.

Turn Count: 95
FoundClues: 6

>d
I couldn't go that way.

Turn Count: 96
FoundClues: 6

>w
East Hallway
Turn Count: 97
FoundClues: 6

>d
I couldn't go that way.

Turn Count: 98
FoundClues: 6

>s
Sumac Room
I could see Scott_Investigation here.

Turn Count: 99
FoundClues: 6

>n
East Hallway
Turn Count: 100
FoundClues: 6

>w
Upstairs Hallway
Turn Count: 101
FoundClues: 6

>d
Downstairs Hallway
A long narrow corridor connected the entrance of the house with the bedrooms. Lights were recessed into the ceiling overhead, shining down onto the polished wood floor. Maybe some people liked this sterile modern crap, but it made the place look like an art gallery, as far as I was concerned. A couple of paintings even adorned the walls, so maybe that was the idea, and I was just uncultured.

Turn Count: 102
FoundClues: 6

>e
Kitchen
I stepped into a kitchen big enough for a game of football. Wooden cabinets and handsome tile in earth tones went from wall to wall. The quaint country look was somewhat ruined by the collection of modern stainless steel kitchen appliances. They were brand new and it looked like not one of them had been used. It figured, this didn't seem like the kind of place that had a cooking staff.

Turn Count: 103
FoundClues: 6

>s
I couldn't go that way.

Turn Count: 104
FoundClues: 6

>w
Downstairs Hallway
A long narrow corridor connected the entrance of the house with the bedrooms. Lights were recessed into the ceiling overhead, shining down onto the polished wood floor. Maybe some people liked this sterile modern crap, but it made the place look like an art gallery, as far as I was concerned. A couple of paintings even adorned the walls, so maybe that was the idea, and I was just uncultured.

Turn Count: 105
FoundClues: 6

>s
I couldn't go that way.

Turn Count: 106
FoundClues: 6

>d
Wine Cellar
The second I walked into the dark wine cellar, recessed lights in the ceiling turned on, probably activated by a motion sensor. 

 A wine rack ran the perimeter of the room, holding enough bottles to supply a French restaurant. A few seemed to be missing here and there. A wooden chair sat in the corner.

Turn Count: 107
FoundClues: 6

>scenes
Scene 'Entire Game' playing (for 107 mins now)
Scene 'Mountain_Driving' ended
Scene 'Car_Escape' ended
Scene 'Cliff_Climbing' ended
Scene 'Car_Embarking' ended
Scene 'Riding_Scene' ended
Scene 'Body_Discovery' ended
Scene 'Prearrival' ended
Scene 'Guest_Arrival' ended
Scene 'First_Investigation' ended
Scene 'First_Sleep' ended
Scene 'Wakeup' ended
Scene 'Interrogation' ended
Scene 'Second_Investigation' ended
Scene 'ComingBack' ended
Scene 'DiscoverDet' playing (for 33 mins now)
(Scene monitoring now switched on. Type "scenes off" to switch it off again.)

* * *

>s
I couldn't go that way.

Turn Count: 72
FoundClues: 6

>e
Greatroom
The greatroom was clearly where the occupants of the house were meant to spend the majority of their time. Tall, dark wooden rafters criscrossed the high ceiling, the exposed beams clearly meant to evoke a Swiss chalet.

A large set of sofas were arranged around a huge rug. A dark wine stain was conspicuous on the armrest, standing out on the white fabric. Everything in the room faced a gray slate fireplace. 

A small spiral staircase in the corner led up to a reading nook, which was open to the greatroom, separated by a wooden balustrade. Coming from somewhere up there I heard "Hark, The Herald Angels Sing" warbling from what sounded like an old radio.

I could see a broken wineglass and a glass shard here.

Turn Count: 73
FoundClues: 6

>d
I couldn't go that way.

Turn Count: 74
FoundClues: 6
Through the stillness of the house, I heard yelling upstairs. It started as a panicked cry of shock and surprise, but quickly turned to screams of agony. It went on, loud and incoherent, muffled by the wooden walls of the house, getting more raspy and strangled, like a pillow smothering a face. Then, just as suddenly, it stopped. I felt a lump in my stomach like a lead weight, and reached for a gun that wasn't there.
(press any key)

>d
I couldn't go that way.

Turn Count: 75
FoundClues: 6

>s
I couldn't go that way.

Turn Count: 76
FoundClues: 6

>n
I couldn't go that way.

Turn Count: 77
FoundClues: 6

>w
Foyer
I walked into the spacious foyer, trying not to walk into the large lacquered wood screens in front of the door. The shiny black surfaces were decorated with an intricate picture in gold paint, depicting a Chinese court scene. It seemed at odds with the exterior of the house, but matched the rest of the decor; the interior was a mixture of Old World furniture and Asian influences. 

There was something about the door that looked like a B&E job.

Turn Count: 78
FoundClues: 6

>d
I couldn't go that way.

Turn Count: 79
FoundClues: 6

>e
Greatroom
The greatroom was clearly where the occupants of the house were meant to spend the majority of their time. Tall, dark wooden rafters criscrossed the high ceiling, the exposed beams clearly meant to evoke a Swiss chalet.

A large set of sofas were arranged around a huge rug. A dark wine stain was conspicuous on the armrest, standing out on the white fabric. Everything in the room faced a gray slate fireplace. 

A small spiral staircase in the corner led up to a reading nook, which was open to the greatroom, separated by a wooden balustrade. Coming from somewhere up there I heard "Angels We Have Heard on High" warbling from what sounded like an old radio.

I could see a broken wineglass and a glass shard here.

Turn Count: 80
FoundClues: 6

>s
I couldn't go that way.

Turn Count: 81
FoundClues: 6

>w
Foyer
I walked into the spacious foyer, trying not to walk into the large lacquered wood screens in front of the door. The shiny black surfaces were decorated with an intricate picture in gold paint, depicting a Chinese court scene. It seemed at odds with the exterior of the house, but matched the rest of the decor; the interior was a mixture of Old World furniture and Asian influences. 

There was something about the door that looked like a B&E job.

Turn Count: 82
FoundClues: 6

>s
I couldn't go that way.

Turn Count: 83
FoundClues: 6

>d
I couldn't go that way.

Turn Count: 84
FoundClues: 6

>scenes
Scene 'Entire Game' playing (for 84 mins now)
Scene 'Mountain_Driving' ended
Scene 'Car_Escape' ended
Scene 'Cliff_Climbing' ended
Scene 'Car_Embarking' ended
Scene 'Riding_Scene' ended
Scene 'Body_Discovery' ended
Scene 'Prearrival' ended
Scene 'Guest_Arrival' ended
Scene 'First_Investigation' ended
Scene 'First_Sleep' ended
Scene 'Wakeup' ended
Scene 'Interrogation' ended
Scene 'Second_Investigation' ended
Scene 'ComingBack' ended
Scene 'DiscoverDet' playing (for 10 mins now)
(Scene monitoring now switched on. Type "scenes off" to switch it off again.)

>look
Foyer
I walked into the spacious foyer, trying not to walk into the large lacquered wood screens in front of the door. The shiny black surfaces were decorated with an intricate picture in gold paint, depicting a Chinese court scene. It seemed at odds with the exterior of the house, but matched the rest of the decor; the interior was a mixture of Old World furniture and Asian influences. 

There was something about the door that looked like a B&E job.

Turn Count: 85
FoundClues: 6

>scenes
Scene 'Entire Game' playing (for 85 mins now)
Scene 'Mountain_Driving' ended
Scene 'Car_Escape' ended
Scene 'Cliff_Climbing' ended
Scene 'Car_Embarking' ended
Scene 'Riding_Scene' ended
Scene 'Body_Discovery' ended
Scene 'Prearrival' ended
Scene 'Guest_Arrival' ended
Scene 'First_Investigation' ended
Scene 'First_Sleep' ended
Scene 'Wakeup' ended
Scene 'Interrogation' ended
Scene 'Second_Investigation' ended
Scene 'ComingBack' ended
Scene 'DiscoverDet' playing (for 11 mins now)
(Scene monitoring now switched on. Type "scenes off" to switch it off again.)

>w
(first opening the front door)
It seemed to be locked.

Turn Count: 86
FoundClues: 6

>n
I couldn't go that way.

Turn Count: 87
FoundClues: 6

>d
I couldn't go that way.

Turn Count: 88
FoundClues: 6

>u
I couldn't go that way.

Turn Count: 89
FoundClues: 6

>d
I couldn't go that way.

Turn Count: 90
FoundClues: 6

>scenes
Scene 'Entire Game' playing (for 90 mins now)
Scene 'Mountain_Driving' ended
Scene 'Car_Escape' ended
Scene 'Cliff_Climbing' ended
Scene 'Car_Embarking' ended
Scene 'Riding_Scene' ended
Scene 'Body_Discovery' ended
Scene 'Prearrival' ended
Scene 'Guest_Arrival' ended
Scene 'First_Investigation' ended
Scene 'First_Sleep' ended
Scene 'Wakeup' ended
Scene 'Interrogation' ended
Scene 'Second_Investigation' ended
Scene 'ComingBack' ended
Scene 'DiscoverDet' playing (for 16 mins now)
(Scene monitoring now switched on. Type "scenes off" to switch it off again.)

>u
I couldn't go that way.

Turn Count: 91
FoundClues: 6

>look
Foyer
I walked into the spacious foyer, trying not to walk into the large lacquered wood screens in front of the door. The shiny black surfaces were decorated with an intricate picture in gold paint, depicting a Chinese court scene. It seemed at odds with the exterior of the house, but matched the rest of the decor; the interior was a mixture of Old World furniture and Asian influences. 

There was something about the door that looked like a B&E job.

Turn Count: 92
FoundClues: 6

>e
Greatroom
The greatroom was clearly where the occupants of the house were meant to spend the majority of their time. Tall, dark wooden rafters criscrossed the high ceiling, the exposed beams clearly meant to evoke a Swiss chalet.

A large set of sofas were arranged around a huge rug. A dark wine stain was conspicuous on the armrest, standing out on the white fabric. Everything in the room faced a gray slate fireplace. 

A small spiral staircase in the corner led up to a reading nook, which was open to the greatroom, separated by a wooden balustrade. Coming from somewhere up there I heard "God Rest Ye Merry, Gentlemen" warbling from what sounded like an old radio.

I could see a broken wineglass and a glass shard here.

Turn Count: 93
FoundClues: 6

>d
I couldn't go that way.

Turn Count: 94
FoundClues: 6

>d
I couldn't go that way.

Turn Count: 95
FoundClues: 6

>e
Downstairs Hallway
A long narrow corridor connected the entrance of the house with the bedrooms. Lights were recessed into the ceiling overhead, shining down onto the polished wood floor. Maybe some people liked this sterile modern crap, but it made the place look like an art gallery, as far as I was concerned. A couple of paintings even adorned the walls, so maybe that was the idea, and I was just uncultured.

Turn Count: 96
FoundClues: 6

>d
Wine Cellar
The second I walked into the dark wine cellar, recessed lights in the ceiling turned on, probably activated by a motion sensor. 

 A wine rack ran the perimeter of the room, holding enough bottles to supply a French restaurant. A few seemed to be missing here and there. A wooden chair sat in the corner.

[Scene 'DiscoverDet' ends]
I was so focused on trying to read the labels on the fuse box that I didn't notice the footsteps behind me. Maybe I wouldn't have anyway. I heard a dull crack and realized it was the sound of a heavy bottle hitting the back of my head. It was the last thing I remembered thinking about before the rush of unconsciousness. I was out before I hit the floor.
(press any key)[Scene 'CellarThink' begins]

*** Run-time problem P61: Attempt to move the player off-stage.

Turn Count: 97
FoundClues: 6

* * *

>enter mercedes
Driveway
We stood at the end of a long gravel drive, staring up at a large house with a dark red wood exterior. Steps to the east led to a porch that spanned the facade of the place, wrapping around to a deck in the back that presumably had a great view of the lake and the countryside. It was more ski lodge than cabin, and looked like it could comfortably shelter an entire biathlon team if it had to.

Val's Mercedes was parked to one side of the driveway.

I could also see Val_SecondInv_TODO here.

Turn Count: 64
FoundClues: 5

>enter mercedes
Sharp Bend
I walked on the snowy road about a hundred feet from the hairpin turn where my car had gone over; I could see the tire tracks and broken guardrail to the east.

A Mercedes is quietly idling here, V8 purring.

I could also see Val_SecondInv_TODO here.

Turn Count: 65
FoundClues: 5

>d
Bottom of Cliff
I stood on a ridge densely packed with trees some ways below the highway. My overturned car sat a few feet away. The ridge extended as far as I could see to the north, going nowhere in particular. To the west I saw the steep incline the car had rolled down, and the path it'd cut through the snow and brush.

I walked over to the car and crouched down beside it to look for clues. There had to be something to tell me if Val's hunch was right or not.

Turn Count: 66
FoundClues: 5

* * *

>test
>--> The following tests are available:
'test firstconvo'
'test sunrise_lose'
'test discover'
'test body'
'test arrival'
'test myclues'
'test valinvest'
'test janinv'
'test master'
'test computer'
'test bedtime'
'test vdet'
'test cartrip'
'test gettinbopped'
'test me'

>t gettinbopped
I wasn't talking to anyone.

* * *

>x door
A large wooden door, painted white as a preacher's picket fence. It didn't have a window or peephole. Something seemed odd about the lock, like it had been damaged. There was splintered wood on the side of the doorframe where someone had apparently forced the door open.

Turn Count: 72
FoundClues: 6

>ook
That noun did not make sense in this context.

>look
Foyer
I walked into the spacious foyer, trying not to walk into the large lacquered wood screens in front of the door. The shiny black surfaces were decorated with an intricate picture in gold paint, depicting a Chinese court scene. It seemed at odds with the exterior of the house, but matched the rest of the decor; the interior was a mixture of Old World furniture and Asian influences. 

Turn Count: 73
FoundClues: 6

>e
Greatroom
The greatroom was clearly where the occupants of the house were meant to spend the majority of their time. Tall, dark wooden rafters criscrossed the high ceiling, the exposed beams clearly meant to evoke a Swiss chalet.

A large set of sofas were arranged around a huge rug. A dark wine stain was conspicuous on the armrest, standing out on the white fabric. Everything in the room faced a gray slate fireplace. 

A small spiral staircase in the corner led up to a reading nook, which was open to the greatroom, separated by a wooden balustrade. Coming from somewhere up there I heard "O Come, All Ye Faithful" warbling from what sounded like an old radio.

I could see a broken wineglass and a glass shard here.

Turn Count: 74
FoundClues: 6
Through the stillness of the house, I heard yelling upstairs. It started as a panicked cry of shock and surprise, but quickly turned to screams of agony. It went on, loud and incoherent, muffled by the wooden walls of the house, getting more raspy and strangled, like a pillow smothering a face. Then, just as suddenly, it stopped. I felt a lump in my stomach like a lead weight, and wished I still had my gun.
(press any key)

>look
Greatroom
The greatroom was clearly where the occupants of the house were meant to spend the majority of their time. Tall, dark wooden rafters criscrossed the high ceiling, the exposed beams clearly meant to evoke a Swiss chalet.

A large set of sofas were arranged around a huge rug. A dark wine stain was conspicuous on the armrest, standing out on the white fabric. Everything in the room faced a gray slate fireplace. 

A small spiral staircase in the corner led up to a reading nook, which was open to the greatroom, separated by a wooden balustrade. Coming from somewhere up there I heard "Hark, The Herald Angels Sing" warbling from what sounded like an old radio.

I could see a broken wineglass and a glass shard here.

Turn Count: 75
FoundClues: 6

>take wineglass
I couldn't see any such thing.

>take broken
I couldn't see any such thing.

>take broken wineglass
I had enough of a mess on my hands without taking this one with me, but kept it anyway. It told an interesting story.

Turn Count: 76
FoundClues: 6

>e
Downstairs Hallway
A long narrow corridor connected the entrance of the house with the bedrooms. Lights were recessed into the ceiling overhead, shining down onto the polished wood floor. Maybe some people liked this sterile modern crap, but it made the place look like an art gallery, as far as I was concerned. A couple of paintings even adorned the walls, so maybe that was the idea, and I was just uncultured.

I could see Adrian here.

Turn Count: 77
FoundClues: 6

>scope
1: myself (849337)
2: Adrian (853433)
3: a painting (851417)
4: a broken wineglass (850873)
5: a cell phone (849369)

>scope Adrian
(Adrian)
1: myself (849337)
2: a broken wineglass (850873)
3: a cell phone (849369)
4: Adrian (853433)
5: a painting (851417)

>showme Adrian
(Adrian)
Adrian - man
location: in Downstairs Hallway
singular-named, proper-named, unmarked for special listing; unlit, inedible, portable, seen, unfamiliar, unexamined, unbroken; male, silent thus far
list grouping key: none
printed name: "Adrian"
printed plural name: "men"
indefinite article: none
summary: none
description: "He stood well over six feet with a build that belonged on the inside of a steel cage. The designer charcoal suit he wore hadn't quite been successfully altered to his wide frame. A deep purple tie sat at his neck in a fat knot Donald Trump would have approved of. The dark hair atop his head was neatly parted at the side, and slicked back almost flat to his head. His eyes were gray, and there was something baleful deep in them, peering out.  His size and heavy brow made him look like a gorilla in Prada."
initial appearance: none
carrying capacity: 100
planned conversation:

* * *

>n/n/n/n/n/n/n/n/n/n/n
That noun did not make sense in this context.

>n;n
That noun did not make sense in this context.

>n
Mountain Pass
I had the radio on tuned to some news station-- truth be told, I already missed the chatter of the dispatch as I was driving. The traffic report had little bearing on my current locale, but the weather gave me some concern: snowstorm coming up off the Great Lakes, apparently. Spending the weekend with a small crowd I barely knew appealed very little to me. Being cooped up with them the entire time due to weather seemed like a recipe for an epidemic of cabin fever.

>n
Hairpin Turn
If I'd finished that last thought a few seconds earlier, I might've noticed the caution sign for the sharp turn, barely visible through the snow. The car was going too fast, and the guardrail came out of nowhere.

* * *

>e
Greatroom
The greatroom was clearly where the occupants of the house were meant to spend the majority of their time. Tall, dark wooden rafters criscrossed the high ceiling, the exposed beams clearly meant to evoke a Swiss chalet.

A large set of sofas were arranged around a huge rug. A dark stain was conspicuous on the armrest, standing out on the white fabric. Everything in the room faced a gray slate fireplace. A fire roared inside, fresh logs having been added not too long ago.

A small spiral staircase in the corner led up to a reading nook, which was open to the greatroom, separated by a wooden balustrade. Coming from somewhere up there I heard "We Three Kings" warbling from what sounded like an old radio.

Whisper quiet, shutters slid down on the inside of every window in the house. They looked like opaque fabric window shades, but the heavy sound of the seal told me the core was probably metal. The moonlight went out as suddenly as if someone had thrown a curtain over it.

(press any key)
FoundClues: 0

>x stain
An oblong dark red spot about the size of a pear stood out from the beige couch. From the color, it looked like wine. As I looked at it, I realized something on the floor was reflecting firelight back at me.

FoundClues: 1

>x shard
A broken shard of glass. The ruined facets of vintage crystal reflected light like a cheap engagement ring.

I crouched down for a closer look and realized it had come from a shattered wineglass,  the pieces obscured by the sofa

FoundClues: 1

>x broken wineglass
The curves of the wineglass were jagged edges now, a heap of shattered crystal under the sofa. It must've fallen from quite a height.

FoundClues: 2

>u
Reading Nook
I climbed the stairs to the reading nook. Shelves lined the walls of the small room, and a couple of books had been knocked off them onto the floor. A pair of wingback armchairs faced each other with a coffee table in between. A small pool of red liquid lay underneath the table.

A man sat in one, slightly paunchy and slightly grey, his eyes and mouth wide open. His glasses were askew. He was wearing a navy blue cardigan, stained all over the front with a dark, almost black liquid. What looked like a small knife was sticking out of his neck, plunged in so far that only the handle was visible.

An antique wooden radio sat on the table, playing Christmas carols.

I could also see a bottle of wine and a wineglass here.

FoundClues: 2