Mercedes is a subject.
Ski chalet is a subject.
Dawn is a subject.

A Long Drink
An Interactive Fiction by PN
Release 1 / Serial number 150116 / Inform 7 build 6L38 (I6/v6.33 lib 6/12N) SD

Mountain Road
They say you shouldn't drive when you're angry. That was just one of a hundred pieces of good advice I was ignoring as I drove north along the icy road to the chalet, my foot a little heavier on the gas than it needed to be.

I'd had a long, promising career in homicide ahead of me, or so I kept telling myself, and it was all down the drain now. I had planned on a senior detective's desk being in the cards for me, at least. Maybe even quitting and going into private investigations. Well, I guessed I could still do that.

Not six hours earlier, I'd turned in my badge and my gun and walked out, more or less the way I'd seen it in the movies. The captain was yelling his head off, couldn't figure out why a promising young detective like me would just up and quit. I honestly hoped he never did.

>hint
That noun did not make sense in this context.

* * *

>e
I couldn't go that way.

FoundClues: 5

>d
Greatroom
The greatroom was clearly where the occupants of the house were meant to spend the majority of their time. Tall, dark wooden rafters criscrossed the high ceiling, the exposed beams clearly meant to evoke a Swiss chalet.

A large set of sofas were arranged around a huge rug. A dark wine stain was conspicuous on the armrest, standing out on the white fabric. Everything in the room faced a gray slate fireplace. A fire roared inside, fresh logs having been added not too long ago.

A small spiral staircase in the corner led up to a reading nook, which was open to the greatroom, separated by a wooden balustrade. Coming from somewhere up there I heard "We Three Kings" warbling from what sounded like an old radio.

I could see a broken wineglass and a glass shard here.

FoundClues: 5

>x shard
A broken shard of glass. It came from a broken wineglass in the greatroom. The ruined facets of vintage crystal reflected light like a cheap engagement ring.

I crouched down for a closer look and realized it had come from a shattered wineglass,  the pieces obscured by the sofa

FoundClues: 5

>d
I couldn't go that way.

FoundClues: 5

>e
Downstairs Hallway
A long narrow corridor connected the entrance of the house with the bedrooms. Lights were recessed into the ceiling overhead, shining down onto the polished wood floor. Maybe some people liked this sterile modern crap, but it made the place look like an art gallery, as far as I was concerned. A couple of paintings even adorned the walls, so maybe that was the idea, and I was just uncultured.

FoundClues: 5

>e
Kitchen
I stepped into a kitchen big enough for a game of football. Wooden cabinets and handsome tile in earth tones went from wall to wall. The quaint country look was somewhat ruined by the collection of modern stainless steel kitchen appliances. They were brand new and it looked like not one of them had been used. It figured, this didn't seem like the kind of place that had a cooking staff.

FoundClues: 5

>w
Downstairs Hallway
A long narrow corridor connected the entrance of the house with the bedrooms. Lights were recessed into the ceiling overhead, shining down onto the polished wood floor. Maybe some people liked this sterile modern crap, but it made the place look like an art gallery, as far as I was concerned. A couple of paintings even adorned the walls, so maybe that was the idea, and I was just uncultured.

FoundClues: 5

>n
Office
FoundClues: 5

* * *

>rules on
Rules tracing now switched on. Type "rules off" to switch it off again, or "rules all" to include even rules which do not apply.

* * *

>x cell phone
[Rule "flatten ifs rule" applies.]
[Rule "thrashing hopelessly rule" applies.]
[Rule "After reading a command" applies.]
[Rule "After reading a command" applies.]
[Rule "After reading a command" applies.]
[Rule "After reading a command" applies.]
[Rule "declare everything initially unmentioned rule" applies.]
[Rule "announce items from multiple object lists rule" applies.]
[Rule "set pronouns from items from multiple object lists rule" applies.]
[Rule "before stage rule" applies.]
[Rule "Before examining a noun" applies.]
[Rule "can't act in the dark rule" applies.]
[Rule "instead stage rule" applies.]
[Rule "investigate player's awareness before action rule" applies.]
[Rule "player aware of his own actions rule" applies.]
[Rule "check stage rule" applies.]
[Rule "carry out stage rule" applies.]
[Rule "mark items as seen on examining rule" applies.]
[Rule "standard examining rule" applies.]
[Rule "examine directions rule" applies.]
[Rule "examine containers rule" applies.]
[Rule "examine supporters rule" applies.]
[Rule "examine devices rule" applies.]
[Rule "examine undescribed things rule" applies.]
I saw nothing special about the cell phone.
[Rule "after stage rule" applies.]

[Rule "investigate player's awareness after action rule" applies.]
[Rule "report stage rule" applies.]
[Rule "report other people examining rule" applies.]
[Rule "last specific action-processing rule" applies.]
[Rule "A first turn sequence rule" applies.]
[Rule "every turn stage rule" applies.]
[Rule "reset protocol rule" applies.]
[Rule "active conversation rule" applies.]
[Rule "everyone speaks if queued rule" applies.]
[Rule "characters remind you if you are ignoring them rule" applies.]
[Rule "free to speak again rule" applies.]
[Rule "Every turn" applies.]
FoundClues: 1
[Rule "A last turn sequence rule" applies.]
[Rule "relabel available quips rule" applies.]
[Rule "don't talk to no one rule" applies.]
[Rule "don't talk to no one rule" applies.]
[Rule "don't talk to no one rule" applies.]
[Rule "don't talk to no one rule" applies.]
[Rule "don't talk to no one rule" applies.]
[Rule "don't talk to no one rule" applies.]
[Rule "don't talk to no one rule" applies.]
[Rule "don't talk to no one rule" applies.]
[Rule "don't talk to no one rule" applies.]
[Rule "don't talk to no one rule" applies.]
[Rule "don't talk to no one rule" applies.]
[Rule "don't talk to no one rule" applies.]
[Rule "don't talk to no one rule" applies.]
[Rule "don't talk to no one rule" applies.]
[Rule "don't talk to no one rule" applies.]
[Rule "don't talk to no one rule" applies.]
[Rule "don't talk to no one rule" applies.]
[Rule "don't talk to no one rule" applies.]
[Rule "don't talk to no one rule" applies.]
[Rule "offer hint quips rule" applies.]
[Rule "initialize quip plausibility before hinting rule" applies.]
[Rule "standard quip plausibility rule" applies.]
[Rule "notify score changes rule" applies.]

>x cell phone
[Rule "flatten ifs rule" applies.]
[Rule "thrashing hopelessly rule" applies.]
[Rule "After reading a command" applies.]
[Rule "After reading a command" applies.]
[Rule "After reading a command" applies.]
[Rule "After reading a command" applies.]
[Rule "declare everything initially unmentioned rule" applies.]
[Rule "announce items from multiple object lists rule" applies.]
[Rule "set pronouns from items from multiple object lists rule" applies.]
[Rule "before stage rule" applies.]
[Rule "Before examining a noun" applies.]
[Rule "can't act in the dark rule" applies.]
[Rule "instead stage rule" applies.]
[Rule "investigate player's awareness before action rule" applies.]
[Rule "player aware of his own actions rule" applies.]
[Rule "check stage rule" applies.]
[Rule "carry out stage rule" applies.]
[Rule "mark items as seen on examining rule" applies.]
[Rule "standard examining rule" applies.]
[Rule "examine directions rule" applies.]
[Rule "examine containers rule" applies.]
[Rule "examine supporters rule" applies.]
[Rule "examine devices rule" applies.]
[Rule "examine undescribed things rule" applies.]
I saw nothing special about the cell phone.
[Rule "after stage rule" applies.]

[Rule "investigate player's awareness after action rule" applies.]
[Rule "report stage rule" applies.]
[Rule "report other people examining rule" applies.]
[Rule "last specific action-processing rule" applies.]
[Rule "A first turn sequence rule" applies.]
[Rule "every turn stage rule" applies.]
[Rule "reset protocol rule" applies.]
[Rule "active conversation rule" applies.]
[Rule "everyone speaks if queued rule" applies.]
[Rule "characters remind you if you are ignoring them rule" applies.]
[Rule "free to speak again rule" applies.]
[Rule "Every turn" applies.]
FoundClues: 1
[Rule "A last turn sequence rule" applies.]
[Rule "relabel available quips rule" applies.]
[Rule "don't talk to no one rule" applies.]
[Rule "don't talk to no one rule" applies.]
[Rule "don't talk to no one rule" applies.]
[Rule "don't talk to no one rule" applies.]
[Rule "don't talk to no one rule" applies.]
[Rule "don't talk to no one rule" applies.]
[Rule "don't talk to no one rule" applies.]
[Rule "don't talk to no one rule" applies.]
[Rule "don't talk to no one rule" applies.]
[Rule "don't talk to no one rule" applies.]
[Rule "don't talk to no one rule" applies.]
[Rule "don't talk to no one rule" applies.]
[Rule "don't talk to no one rule" applies.]
[Rule "don't talk to no one rule" applies.]
[Rule "don't talk to no one rule" applies.]
[Rule "don't talk to no one rule" applies.]
[Rule "don't talk to no one rule" applies.]
[Rule "don't talk to no one rule" applies.]
[Rule "don't talk to no one rule" applies.]
[Rule "offer hint quips rule" applies.]
[Rule "initialize quip plausibility before hinting rule" applies.]
[Rule "standard quip plausibility rule" applies.]
[Rule "notify score changes rule" applies.]

>i
[Rule "flatten ifs rule" applies.]
[Rule "thrashing hopelessly rule" applies.]
[Rule "After reading a command" applies.]
[Rule "After reading a command" applies.]
[Rule "After reading a command" applies.]
[Rule "After reading a command" applies.]
[Rule "declare everything initially unmentioned rule" applies.]
[Rule "announce items from multiple object lists rule" applies.]
[Rule "set pronouns from items from multiple object lists rule" applies.]
[Rule "before stage rule" applies.]
[Rule "instead stage rule" applies.]
[Rule "investigate player's awareness before action rule" applies.]
[Rule "player aware of his own actions rule" applies.]
[Rule "check stage rule" applies.]
[Rule "carry out stage rule" applies.]
[Rule "print empty inventory rule" applies.]
[Rule "print standard inventory rule" applies.]
I was carrying:
  a cell phone
[Rule "after stage rule" applies.]

[Rule "investigate player's awareness after action rule" applies.]
[Rule "report stage rule" applies.]
[Rule "report other people taking inventory rule" applies.]
[Rule "last specific action-processing rule" applies.]
[Rule "A first turn sequence rule" applies.]
[Rule "every turn stage rule" applies.]
[Rule "reset protocol rule" applies.]
[Rule "active conversation rule" applies.]
[Rule "everyone speaks if queued rule" applies.]
[Rule "characters remind you if you are ignoring them rule" applies.]
[Rule "free to speak again rule" applies.]
[Rule "Every turn" applies.]
FoundClues: 1
[Rule "A last turn sequence rule" applies.]
[Rule "relabel available quips rule" applies.]
[Rule "don't talk to no one rule" applies.]
[Rule "don't talk to no one rule" applies.]
[Rule "don't talk to no one rule" applies.]
[Rule "don't talk to no one rule" applies.]
[Rule "don't talk to no one rule" applies.]
[Rule "don't talk to no one rule" applies.]
[Rule "don't talk to no one rule" applies.]
[Rule "don't talk to no one rule" applies.]
[Rule "don't talk to no one rule" applies.]
[Rule "don't talk to no one rule" applies.]
[Rule "don't talk to no one rule" applies.]
[Rule "don't talk to no one rule" applies.]
[Rule "don't talk to no one rule" applies.]
[Rule "don't talk to no one rule" applies.]
[Rule "don't talk to no one rule" applies.]
[Rule "don't talk to no one rule" applies.]
[Rule "don't talk to no one rule" applies.]
[Rule "don't talk to no one rule" applies.]
[Rule "don't talk to no one rule" applies.]
[Rule "offer hint quips rule" applies.]
[Rule "initialize quip plausibility before hinting rule" applies.]
[Rule "standard quip plausibility rule" applies.]
[Rule "notify score changes rule" applies.]

>scope
[Rule "flatten ifs rule" applies.]
[Rule "thrashing hopelessly rule" applies.]
[Rule "After reading a command" applies.]
[Rule "After reading a command" applies.]
[Rule "After reading a command" applies.]
[Rule "After reading a command" applies.]
[Rule "declare everything initially unmentioned rule" applies.]
1: radio (786076)
2: Window (786044)
3: Road (786012)
4: myself (785820)
5: a cell phone (785852)

>x radio
[Rule "flatten ifs rule" applies.]
[Rule "thrashing hopelessly rule" applies.]
[Rule "After reading a command" applies.]
[Rule "After reading a command" applies.]
[Rule "After reading a command" applies.]
[Rule "After reading a command" applies.]
[Rule "quips are not visible rule" applies.]
I couldn't see any such thing.

* * *

I beg your pardon?

>les off
[Rule "flatten ifs rule" applies.]
[Rule "thrashing hopelessly rule" applies.]
[Rule "After reading a command" applies.]
[Rule "After reading a command" applies.]
[Rule "After reading a command" applies.]
[Rule "After reading a command" applies.]
[Rule "quip scope handling rule" applies.]
[Rule "quips are not visible rule" applies.]
That noun did not make sense in this context.

>rules off
[Rule "flatten ifs rule" applies.]
[Rule "thrashing hopelessly rule" applies.]
[Rule "After reading a command" applies.]
[Rule "After reading a command" applies.]
[Rule "After reading a command" applies.]
[Rule "After reading a command" applies.]
[Rule "declare everything initially unmentioned rule" applies.]
Rules tracing now switched off. Type "rules" to switch it on again.

>look
Reading Nook
I climbed the stairs to the reading nook. Shelves lined the walls of the small room, and a couple of books had been knocked off them onto the floor. A pair of wingback armchairs faced each other with a coffee table in between. A small pool of red liquid lay underneath the table.

A man sat in one, slightly paunchy and slightly grey, his eyes and mouth wide open. His glasses were askew. He was wearing a navy blue cardigan, stained all over the front with a dark, almost black liquid. What looked like a small knife was sticking out of his neck, plunged in so far that only the handle was visible.

An antique wooden radio sat on the table, playing Christmas carols.

I could also see a bottle of wine and a wineglass here.

FoundClues: 0
FoundClues: 0

>x wine
(the bottle of wine)
A Bordeaux from back in 2001, uncorked and almost empty. Expensive bottle to be drinking alone.

FoundClues: 0
FoundClues: 0

* * *

>showme
Reading Nook - room
    myself - person
        cell phone
    body
    knife - clue
    shelves
    books
    radio - device
    pool of wine - clue
    bottle of wine - clue
    wineglass - clue

>look
Reading Nook
I climbed the stairs to the reading nook. Shelves lined the walls of the small room, and a couple of books had been knocked off them onto the floor. A pair of wingback armchairs faced each other with a coffee table in between. A small pool of red liquid lay underneath the table.

A man sat in one, slightly paunchy and slightly grey, his eyes and mouth wide open. His glasses were askew. He was wearing a navy blue cardigan, stained all over the front with a dark, almost black liquid. What looked like a small knife was sticking out of his neck, plunged in so far that only the handle was visible.

An antique wooden radio sat on the table, playing Christmas carols.

I could also see a bottle of wine and a wineglass here.

FoundClues: 0
FoundClues: 0

>d
Greatroom
The greatroom was clearly where the occupants of the house were meant to spend the majority of their time. Tall, dark wooden rafters criscrossed the high ceiling, the exposed beams clearly meant to evoke a Swiss chalet.

A large set of sofas were arranged around a huge rug. A dark stain was conspicuous on the armrest, standing out on the white fabric. Everything in the room faced a gray slate fireplace. A fire roared inside, fresh logs having been added not too long ago.

A small spiral staircase in the corner led up to a reading nook, which was open to the greatroom, separated by a wooden balustrade. Coming from somewhere up there I heard "Angels We Have Heard on High" warbling from what sounded like an old radio.

FoundClues: 0
FoundClues: 0

>x stain
An oblong dark red spot about the size of a pear stood out from the beige couch. From the color, it looked like wine. As I was looking at it, I realized something on the floor was reflecting firelight back at me.

FoundClues: 1
FoundClues: 1

>clues
Clues

stain on Greatroom sofa

>u
Reading Nook
I climbed the stairs to the reading nook. Shelves lined the walls of the small room, and a couple of books had been knocked off them onto the floor. A pair of wingback armchairs faced each other with a coffee table in between. A small pool of red liquid lay underneath the table.

A man sat in one, slightly paunchy and slightly grey, his eyes and mouth wide open. His glasses were askew. He was wearing a navy blue cardigan, stained all over the front with a dark, almost black liquid. What looked like a small knife was sticking out of his neck, plunged in so far that only the handle was visible.

An antique wooden radio sat on the table, playing Christmas carols.

I could also see a bottle of wine and a wineglass here.

FoundClues: 1
FoundClues: 1

>x knife
It looked like a silver carving knife with an ivory handle. A monogram on the end read "AHB". It didn't look that long or that sharp, but someone had made a pretty clean business of stabbing Bowden with it. Or maybe they'd just gotten lucky. It happens like that sometimes.

FoundClues: 1
FoundClues: 1

>clues
Clues

stain on Greatroom sofa

knife

>rules
Rules tracing now switched on. Type "rules off" to switch it off again, or "rules all" to include even rules which do not apply.

* * *

>look
Mountain Road
They say you shouldn't drive when you're angry. That was just one of a hundred pieces of good advice I was ignoring as I drove north along the icy road to the chalet, my foot a little heavier on the gas than it needed to be.

I'd had a long, promising career in homicide ahead of me, or so I kept telling myself, and it was all down the drain now. I had planned on a senior detective's desk being in the cards for me, at least. Maybe even quitting and going into private investigations. Well, I guessed I could still do that.

Not six hours earlier, I'd turned in my badge and my gun and walked out, more or less the way I'd seen it in the movies. The captain was yelling his head off, couldn't figure out why a promising young detective like me would just up and quit. I honestly hoped he never did.

FoundClues: 0

>i
I was carrying:
  a cell phone

>help
That noun did not make sense in this context.

>clues
That noun did not make sense in this context.

* * *

>x broken_wineglass
I couldn't see any such thing.

* * *

>look
Mountain Road
They say you shouldn't drive when you're angry. That was just one of a hundred pieces of good advice I was ignoring as I drove north along the icy road to the chalet, my foot a little heavier on the gas than it needed to be.

I'd had a long, promising career in homicide ahead of me, or so I kept telling myself, and it was all down the drain now. I had planned on a senior detective's desk being in the cards for me, at least. Maybe even quitting and going into private investigations. Well, I guessed I could still do that.

Not six hours earlier, I'd turned in my badge and my gun and walked out, more or less the way I'd seen it in the movies. The captain was yelling his head off, couldn't figure out why a promising young detective like me would just up and quit. I honestly hoped he never did.

* * *

>d
Greatroom
The greatroom was clearly where the occupants of the house were meant to spend the majority of their time. Tall dark rafters criscrossed the high ceiling, the exposed beams clearly meant to evoke a Swiss chalet.

A large set of sofas were arranged around a huge rug. A dark stain was conspicuous against the pattern of the fabric. Everything in the room faced a gray slate fireplace. A fire roared inside, fresh logs having been added not too long ago.

A small spiral staircase in the corner led up to a reading nook, which was open to the greatroom, separated by a wooden balustrade. Coming from somewhere up there I could hear "Hark, The Herald Angels Sing" warbling from what sounded like an old radio.

>x sofa
I saw nothing special about the sofa.

>s shard
I only understood you as far as wanting to (go) s.

>x shard
A broken piece of crystal. The ruined facets of vintage cut crystal reflected light like a cheap engagement ring.

>x broken wineglass
The curves of the wineglass were jagged edges now, a heap of shattered crystal under the sofa. It must've fallen from quite a height.

>look
Greatroom
The greatroom was clearly where the occupants of the house were meant to spend the majority of their time. Tall dark rafters criscrossed the high ceiling, the exposed beams clearly meant to evoke a Swiss chalet.

A large set of sofas were arranged around a huge rug. A dark stain was conspicuous against the pattern of the fabric. Everything in the room faced a gray slate fireplace. A fire roared inside, fresh logs having been added not too long ago.

A small spiral staircase in the corner led up to a reading nook, which was open to the greatroom, separated by a wooden balustrade. Coming from somewhere up there I could hear "O Come, All Ye Faithful" warbling from what sounded like an old radio.

I could see a broken wineglass here.

>i
I was carrying:
  a cell phone

>look
Greatroom
The greatroom was clearly where the occupants of the house were meant to spend the majority of their time. Tall dark rafters criscrossed the high ceiling, the exposed beams clearly meant to evoke a Swiss chalet.

A large set of sofas were arranged around a huge rug. A dark stain was conspicuous against the pattern of the fabric. Everything in the room faced a gray slate fireplace. A fire roared inside, fresh logs having been added not too long ago.

A small spiral staircase in the corner led up to a reading nook, which was open to the greatroom, separated by a wooden balustrade. Coming from somewhere up there I could hear "Angels We Have Heard on High" warbling from what sounded like an old radio.

I could see a broken wineglass here.

* * *

>look
Reading Nook
I climbed the stairs to the reading nook. Shelves lined the walls of the small room, and a couple of books had been knocked off them onto the floor. A pair of wingback armchairs faced each other with a coffee table in between. A small pool of red liquid lay underneath the table.

A man sat in one, slightly paunchy and slightly grey, his eyes and mouth wide open. His glasses were askew. He was wearing a navy blue cardigan, stained all over the front with a dark, almost black liquid. What looked like a small knife was sticking out of his neck, plunged in so far that only the handle was visible.

An antique wooden radio sat on the table, playing Christmas carols.

I could also see a bottle of wine and a wineglass here.

FoundClues: 0

>x wine
(the bottle of wine)
A Bordeaux from back in 2001, uncorked and almost empty. Expensive bottle to be drinking alone.

FoundClues: 1

>x wineglass
A crystal wineglass, empty but for a few drops of red wine at the bottom.

FoundClues: 2

>x wineglass
A crystal wineglass, empty but for a few drops of red wine at the bottom.

FoundClues: 2

>x knife
It looked like a silver carving knife with an ivory handle. A monogram on the end read "AHB". It didn't look that long or that sharp, but someone had made a pretty clean business of stabbing Bowden with it. Or maybe they'd just gotten lucky. It happens like that sometimes.

FoundClues: 3

>d
Greatroom
The greatroom was clearly where the occupants of the house were meant to spend the majority of their time. Tall, dark wooden rafters criscrossed the high ceiling, the exposed beams clearly meant to evoke a Swiss chalet.

A large set of sofas were arranged around a huge rug. A dark stain was conspicuous on the armrest, standing out on the white fabric. Everything in the room faced a gray slate fireplace. A fire roared inside, fresh logs having been added not too long ago.

A small spiral staircase in the corner led up to a reading nook, which was open to the greatroom, separated by a wooden balustrade. Coming from somewhere up there I heard "Hark, The Herald Angels Sing" warbling from what sounded like an old radio.

FoundClues: 3

>x stain
An oblong dark red spot about the size of a pear stood out from the beige couch. From the color, it looked like wine. As I looked at it, I realized something on the floor was reflecting firelight back at me.

FoundClues: 4

>x shard
A broken shard of glass. The ruined facets of vintage crystal reflected light like a cheap engagement ring.

I crouched down for a closer look and realized it had come from a shattered wineglass,  the pieces obscured by the sofa

FoundClues: 4

>look
Greatroom
The greatroom was clearly where the occupants of the house were meant to spend the majority of their time. Tall, dark wooden rafters criscrossed the high ceiling, the exposed beams clearly meant to evoke a Swiss chalet.

A large set of sofas were arranged around a huge rug. A dark wine stain was conspicuous on the armrest, standing out on the white fabric. Everything in the room faced a gray slate fireplace. A fire roared inside, fresh logs having been added not too long ago.

A small spiral staircase in the corner led up to a reading nook, which was open to the greatroom, separated by a wooden balustrade. Coming from somewhere up there I heard "We Three Kings" warbling from what sounded like an old radio.

I could see a broken wineglass and a glass shard here.

FoundClues: 4

>x broken
I couldn't see any such thing.

>x broken wineglass
The curves of the wineglass were jagged edges now, a heap of shattered crystal under the sofa. It must've fallen from quite a height.

FoundClues: 5

>clues
Clues

broken wineglass
bottle of wine

stain on Greatroom sofa
wineglass

knife

>x body
I couldn't see any such thing.

>look
Greatroom
The greatroom was clearly where the occupants of the house were meant to spend the majority of their time. Tall, dark wooden rafters criscrossed the high ceiling, the exposed beams clearly meant to evoke a Swiss chalet.

A large set of sofas were arranged around a huge rug. A dark wine stain was conspicuous on the armrest, standing out on the white fabric. Everything in the room faced a gray slate fireplace. A fire roared inside, fresh logs having been added not too long ago.

A small spiral staircase in the corner led up to a reading nook, which was open to the greatroom, separated by a wooden balustrade. Coming from somewhere up there I heard "We Three Kings" warbling from what sounded like an old radio.

I could see a broken wineglass and a glass shard here.

FoundClues: 5

>x ceiling
I saw nothing special about the ceiling.

FoundClues: 5

>x staircase
I saw nothing special about the staircase.

FoundClues: 5

>x rug
I looked at the plush carpet, checking it for footprints. A shoe size can be pretty damn circumstantial, but at this point, I needed every clue I could get.

I didn't see one, it was just as pristine as the drifts of snow in the valley below.

But something caught my eye, something small and sharp, glinting in the light of the room as I walked the perimeter of the rug. A shard of glass by the edge of the sofa.

FoundClues: 5

>d
I couldn't go that way.

FoundClues: 5

>w
Foyer
I walked into the spacious foyer, trying not to walk into the large lacquered screens in front of the door. The shiny black wood was decorated with an intricate picture in gold paint, depicting a Chinese court scene. It seemed at odds with the exterior of the house, but matched the rest of the decor; the interior was a mixture of Old World furniture and Asian influences.

A layer of snow had blown in through the open doorway, and was slowly melting into a puddle on the enormous Persian rug. 

The front door stood open to the porch.
 I could tell right away that something was wrong, like the door had been damaged somehow.

FoundClues: 5

>e
Greatroom
The greatroom was clearly where the occupants of the house were meant to spend the majority of their time. Tall, dark wooden rafters criscrossed the high ceiling, the exposed beams clearly meant to evoke a Swiss chalet.

A large set of sofas were arranged around a huge rug. A dark wine stain was conspicuous on the armrest, standing out on the white fabric. Everything in the room faced a gray slate fireplace. A fire roared inside, fresh logs having been added not too long ago.

A small spiral staircase in the corner led up to a reading nook, which was open to the greatroom, separated by a wooden balustrade. Coming from somewhere up there I heard "God Rest Ye Merry, Gentlemen" warbling from what sounded like an old radio.

I could see a glass shard and a broken wineglass here.

FoundClues: 5

>x body
I couldn't see any such thing.

>u
Reading Nook
I climbed the stairs to the reading nook. Shelves lined the walls of the small room, and a couple of books had been knocked off them onto the floor. A pair of wingback armchairs faced each other with a coffee table in between. A small pool of red liquid lay underneath the table.

A man sat in one, slightly paunchy and slightly grey, his eyes and mouth wide open. His glasses were askew. He was wearing a navy blue cardigan, stained all over the front with a dark, almost black liquid. What looked like a small knife was sticking out of his neck, plunged in so far that only the handle was visible.

An antique wooden radio sat on the table, playing Christmas carols.

I could also see a bottle of wine and a wineglass here.

FoundClues: 5

>x body
He looked like he was fifty, but something about his well-preserved look told me that he was probably sixty. It wasn't that he was in good shape-- I doubted he'd seen much real exercise since he was in high school, and maybe not even then. He struck me as a debate team sort of guy.  I could tell he didn't get out much. His fingers were broad, but smooth. His hands had no calluses and no rings, but he wore a Rolex watch. It wasn't fake, and had cost probably three times what my car was worth before I'd driven it off a cliff a few hours ago.

Val came up the stairs, freezing the second she saw the body. Her eyes narrowed, and I could tell her mind was racing, the first time I'd seen anything but placid boredom on her face. Half of me was relieved to know that there was something in this world that could perturb her. The other half was unnerved by it. She looked away and hitched the poker face back on pretty quick.

Val nodded at the poor stiff and said, "Meet Professor Alan Bowden, our host this weekend."

FoundClues: 5

>d
Greatroom
The greatroom was clearly where the occupants of the house were meant to spend the majority of their time. Tall, dark wooden rafters criscrossed the high ceiling, the exposed beams clearly meant to evoke a Swiss chalet.

A large set of sofas were arranged around a huge rug. A dark wine stain was conspicuous on the armrest, standing out on the white fabric. Everything in the room faced a gray slate fireplace. A fire roared inside, fresh logs having been added not too long ago.

A small spiral staircase in the corner led up to a reading nook, which was open to the greatroom, separated by a wooden balustrade. Coming from somewhere up there I heard "O Come, All Ye Faithful" warbling from what sounded like an old radio.

I could see a glass shard and a broken wineglass here.

FoundClues: 5

>w
Foyer
I walked into the spacious foyer, trying not to walk into the large lacquered screens in front of the door. The shiny black wood was decorated with an intricate picture in gold paint, depicting a Chinese court scene. It seemed at odds with the exterior of the house, but matched the rest of the decor; the interior was a mixture of Old World furniture and Asian influences. 

The front door stood open to the porch.
 I could tell right away that something was wrong, like the door had been damaged somehow.

FoundClues: 5

>x door
A large wooden door, painted white as a preacher's picket fence. It didn't have a window or peephole. Something seemed odd about the lock, like it had been damaged. There was splintered wood on the side of the doorframe where someone had apparently forced the door open.

FoundClues: 5

>x lock
I couldn't see any such thing.

>e
Greatroom
The greatroom was clearly where the occupants of the house were meant to spend the majority of their time. Tall, dark wooden rafters criscrossed the high ceiling, the exposed beams clearly meant to evoke a Swiss chalet.

A large set of sofas were arranged around a huge rug. A dark wine stain was conspicuous on the armrest, standing out on the white fabric. Everything in the room faced a gray slate fireplace. A fire roared inside, fresh logs having been added not too long ago.

A small spiral staircase in the corner led up to a reading nook, which was open to the greatroom, separated by a wooden balustrade. Coming from somewhere up there I heard "We Three Kings" warbling from what sounded like an old radio.

I could see a glass shard and a broken wineglass here.

FoundClues: 5

>x shard
A broken shard of glass. It came from a broken wineglass in the greatroom. The ruined facets of vintage crystal reflected light like a cheap engagement ring.

I crouched down for a closer look and realized it had come from a shattered wineglass,  the pieces obscured by the sofa

FoundClues: 5

>take shard
A broken shard of glass. It came from a broken wineglass in the greatroom. The ruined facets of vintage crystal reflected light like a cheap engagement ring.

I crouched down for a closer look and realized it had come from a shattered wineglass,  the pieces obscured by the sofa

FoundClues: 5

>look
Greatroom
The greatroom was clearly where the occupants of the house were meant to spend the majority of their time. Tall, dark wooden rafters criscrossed the high ceiling, the exposed beams clearly meant to evoke a Swiss chalet.

A large set of sofas were arranged around a huge rug. A dark wine stain was conspicuous on the armrest, standing out on the white fabric. Everything in the room faced a gray slate fireplace. A fire roared inside, fresh logs having been added not too long ago.

A small spiral staircase in the corner led up to a reading nook, which was open to the greatroom, separated by a wooden balustrade. Coming from somewhere up there I heard "Angels We Have Heard on High" warbling from what sounded like an old radio.

I could see a glass shard and a broken wineglass here.

FoundClues: 5

>x glass shard
A broken shard of glass. It came from a broken wineglass in the greatroom. The ruined facets of vintage crystal reflected light like a cheap engagement ring.

I crouched down for a closer look and realized it had come from a shattered wineglass,  the pieces obscured by the sofa

FoundClues: 5

>look
Greatroom
The greatroom was clearly where the occupants of the house were meant to spend the majority of their time. Tall, dark wooden rafters criscrossed the high ceiling, the exposed beams clearly meant to evoke a Swiss chalet.

A large set of sofas were arranged around a huge rug. A dark wine stain was conspicuous on the armrest, standing out on the white fabric. Everything in the room faced a gray slate fireplace. A fire roared inside, fresh logs having been added not too long ago.

A small spiral staircase in the corner led up to a reading nook, which was open to the greatroom, separated by a wooden balustrade. Coming from somewhere up there I heard "God Rest Ye Merry, Gentlemen" warbling from what sounded like an old radio.

I could see a glass shard and a broken wineglass here.

FoundClues: 5

I beg your pardon?

>e
Downstairs Hallway
A long narrow corridor connected the entrance of the house with the bedrooms. Lights were recessed into the ceiling overhead, shining down onto the polished wood floor. Maybe some people liked this clean modern, but it made the place look like an art gallery, as far as I was concerned. A couple of paintings even adorned the walls, so maybe that was the idea, and I was just uncultured.

FoundClues: 5
I heard the front door open, and the sound of voices from the foyer. It closed a minute later.

>e
Kitchen
The kitchen was probably the largest I've seen in my life. Wooden cabinets and handsome tile in earth tones went from wall to wall. The quaint country look was somewhat ruined by the collection of modern stainless steel kitchen appliances. They were brand new and it looked like not one of them had been used.

FoundClues: 5

>w
Downstairs Hallway
A long narrow corridor connected the entrance of the house with the bedrooms. Lights were recessed into the ceiling overhead, shining down onto the polished wood floor. Maybe some people liked this clean modern, but it made the place look like an art gallery, as far as I was concerned. A couple of paintings even adorned the walls, so maybe that was the idea, and I was just uncultured.

FoundClues: 5

>e
Kitchen
The kitchen was probably the largest I've seen in my life. Wooden cabinets and handsome tile in earth tones went from wall to wall. The quaint country look was somewhat ruined by the collection of modern stainless steel kitchen appliances. They were brand new and it looked like not one of them had been used.

FoundClues: 5

* * *

>clues
Clues

>x shard
I couldn't see any such thing.

>clues
Clues

>x shattered
I couldn't see any such thing.

>i
I was carrying:
  a cell phone

FoundClues: 0

>x cell phone
I saw nothing special about the cell phone.

FoundClues: 0

>look
Reading Nook
I climbed the stairs to the reading nook. Shelves lined the walls of the small room, and a couple of books had been knocked off them onto the floor. A pair of wingback armchairs faced each other with a coffee table in between. A small pool of red liquid lay underneath the table.

A man sat in one, slightly paunchy and slightly grey, his eyes and mouth wide open. His glasses were askew. He was wearing a navy blue cardigan, stained all over the front with a dark, almost black liquid. What looked like a small knife was sticking out of his neck, plunged in so far that only the handle was visible.

An antique wooden radio sat on the table, playing Christmas carols.

I could also see a bottle of wine and a wineglass here.

FoundClues: 0

* * *

>x knife
It looked like a silver carving knife with an ivory handle. A monogram on the end read "AHB". It didn't look that long or that sharp, but someone had made a pretty clean business of stabbing Bowden with it. Or maybe they'd just gotten lucky. It happens like that sometimes.

FoundClues: 3

>d
Greatroom
The greatroom was clearly where the occupants of the house were meant to spend the majority of their time. Tall, dark wooden rafters criscrossed the high ceiling, the exposed beams clearly meant to evoke a Swiss chalet.

A large set of sofas were arranged around a huge rug. A dark stain was conspicuous on the armrest, standing out on the white fabric. Everything in the room faced a gray slate fireplace. A fire roared inside, fresh logs having been added not too long ago.

A small spiral staircase in the corner led up to a reading nook, which was open to the greatroom, separated by a wooden balustrade. Coming from somewhere up there I heard "O Come, All Ye Faithful" warbling from what sounded like an old radio.

FoundClues: 3

>x stain
An oblong dark red spot about the size of a pear stood out from the beige couch. From the color, it looked like wine. As I looked at it, I realized something on the floor was reflecting firelight back at me.

FoundClues: 4

* * *

>x shard
A broken shard of glass. The ruined facets of vintage crystal reflected light like a cheap engagement ring.

I crouched down for a closer look and realized it had come from a shattered wineglass,  the pieces obscured by the sofa

FoundClues: 4

>look
Greatroom
The greatroom was clearly where the occupants of the house were meant to spend the majority of their time. Tall, dark wooden rafters criscrossed the high ceiling, the exposed beams clearly meant to evoke a Swiss chalet.

A large set of sofas were arranged around a huge rug. A dark wine stain was conspicuous on the armrest, standing out on the white fabric. Everything in the room faced a gray slate fireplace. A fire roared inside, fresh logs having been added not too long ago.

A small spiral staircase in the corner led up to a reading nook, which was open to the greatroom, separated by a wooden balustrade. Coming from somewhere up there I heard "Angels We Have Heard on High" warbling from what sounded like an old radio.

I could see a broken wineglass here.

FoundClues: 4

>x broken
I couldn't see any such thing.

* * *

>x body
I couldn't see any such thing.

>look
Greatroom
The greatroom was clearly where the occupants of the house were meant to spend the majority of their time. Tall, dark wooden rafters criscrossed the high ceiling, the exposed beams clearly meant to evoke a Swiss chalet.

A large set of sofas were arranged around a huge rug. A dark wine stain was conspicuous on the armrest, standing out on the white fabric. Everything in the room faced a gray slate fireplace. A fire roared inside, fresh logs having been added not too long ago.

A small spiral staircase in the corner led up to a reading nook, which was open to the greatroom, separated by a wooden balustrade. Coming from somewhere up there I heard "God Rest Ye Merry, Gentlemen" warbling from what sounded like an old radio.

I could see a broken wineglass here.

FoundClues: 5

>x ceiling
I saw nothing special about the ceiling.

FoundClues: 5

* * *

>x body
I couldn't see any such thing.

>look
Greatroom
The greatroom was clearly where the occupants of the house were meant to spend the majority of their time. Tall, dark wooden rafters criscrossed the high ceiling, the exposed beams clearly meant to evoke a Swiss chalet.

A large set of sofas were arranged around a huge rug. A dark wine stain was conspicuous on the armrest, standing out on the white fabric. Everything in the room faced a gray slate fireplace. A fire roared inside, fresh logs having been added not too long ago.

A small spiral staircase in the corner led up to a reading nook, which was open to the greatroom, separated by a wooden balustrade. Coming from somewhere up there I heard "Angels We Have Heard on High" warbling from what sounded like an old radio.

I could see a broken wineglass here.

FoundClues: 5

>x ceiling
I saw nothing special about the ceiling.

FoundClues: 5

* * *

>x staircase
I saw nothing special about the staircase.

FoundClues: 5

>x rug
I looked at the plush carpet, checking it for footprints. A shoe size can be pretty damn circumstantial, but at this point, I needed every clue I could get. I didn't see a thing, it was just as pristine as the drifts of snow in the valley below.
Something caught my eye, something small and sharp, glinting in the light of the room as I walked around it. A shard of glass by the edge of the sofa.

FoundClues: 5

* * *

>i
I was carrying:
  a cell phone

FoundClues: 0

* * *

>x shard
A broken shard of glass. The ruined facets of vintage crystal reflected light like a cheap engagement ring.

I crouched down for a closer look and realized it had come from a shattered wineglass,  the pieces obscured by the sofa

FoundClues: 4

>look
Greatroom
The greatroom was clearly where the occupants of the house were meant to spend the majority of their time. Tall, dark wooden rafters criscrossed the high ceiling, the exposed beams clearly meant to evoke a Swiss chalet.

A large set of sofas were arranged around a huge rug. A dark wine stain was conspicuous on the armrest, standing out on the white fabric. Everything in the room faced a gray slate fireplace. A fire roared inside, fresh logs having been added not too long ago.

A small spiral staircase in the corner led up to a reading nook, which was open to the greatroom, separated by a wooden balustrade. Coming from somewhere up there I heard "O Come, All Ye Faithful" warbling from what sounded like an old radio.

I could see a broken wineglass here.

FoundClues: 4

>x broken
I couldn't see any such thing.

* * *

>x staircase
I saw nothing special about the staircase.

FoundClues: 5

>x rug
I looked at the plush carpet, checking it for footprints. A shoe size can be pretty damn circumstantial, but at this point, I needed every clue I could get.

I didn't see a thing, it was just as pristine as the drifts of snow in the valley below.

Something caught my eye, something small and sharp, glinting in the light of the room as I walked the perimeter of the rug. A shard of glass by the edge of the sofa.

FoundClues: 5

>d
I couldn't go that way.

FoundClues: 5

* * *

>e
Greatroom
The greatroom was clearly where the occupants of the house were meant to spend the majority of their time. Tall, dark wooden rafters criscrossed the high ceiling, the exposed beams clearly meant to evoke a Swiss chalet.

A large set of sofas were arranged around a huge rug. A dark wine stain was conspicuous on the armrest, standing out on the white fabric. Everything in the room faced a gray slate fireplace. A fire roared inside, fresh logs having been added not too long ago.

A small spiral staircase in the corner led up to a reading nook, which was open to the greatroom, separated by a wooden balustrade. Coming from somewhere up there I heard "We Three Kings" warbling from what sounded like an old radio.

I could see a glass shard and a broken wineglass here.

FoundClues: 5

>x body
I couldn't see any such thing.

* * *

>e
I couldn't go that way.

FoundClues: 5

>d
Greatroom
The greatroom was clearly where the occupants of the house were meant to spend the majority of their time. Tall, dark wooden rafters criscrossed the high ceiling, the exposed beams clearly meant to evoke a Swiss chalet.

A large set of sofas were arranged around a huge rug. A dark wine stain was conspicuous on the armrest, standing out on the white fabric. Everything in the room faced a gray slate fireplace. A fire roared inside, fresh logs having been added not too long ago.

A small spiral staircase in the corner led up to a reading nook, which was open to the greatroom, separated by a wooden balustrade. Coming from somewhere up there I heard "God Rest Ye Merry, Gentlemen" warbling from what sounded like an old radio.

I could see a glass shard and a broken wineglass here.

FoundClues: 5

>w
Foyer
I walked into the spacious foyer, trying not to walk into the large lacquered screens in front of the door. The shiny black wood was decorated with an intricate picture in gold paint, depicting a Chinese court scene. It seemed at odds with the exterior of the house, but matched the rest of the decor; the interior was a mixture of Old World furniture and Asian influences. 

The front door stood open to the porch.
 I could tell right away that something was wrong, like the door had been damaged somehow.

FoundClues: 5

* * *

>x lock
I couldn't see any such thing.

>e
Greatroom
The greatroom was clearly where the occupants of the house were meant to spend the majority of their time. Tall, dark wooden rafters criscrossed the high ceiling, the exposed beams clearly meant to evoke a Swiss chalet.

A large set of sofas were arranged around a huge rug. A dark wine stain was conspicuous on the armrest, standing out on the white fabric. Everything in the room faced a gray slate fireplace. A fire roared inside, fresh logs having been added not too long ago.

A small spiral staircase in the corner led up to a reading nook, which was open to the greatroom, separated by a wooden balustrade. Coming from somewhere up there I heard "God Rest Ye Merry, Gentlemen" warbling from what sounded like an old radio.

I could see a glass shard and a broken wineglass here.

FoundClues: 5

>x shard
A broken shard of glass. It came from a broken wineglass in the greatroom. The ruined facets of vintage crystal reflected light like a cheap engagement ring.

I crouched down for a closer look and realized it had come from a shattered wineglass,  the pieces obscured by the sofa

FoundClues: 5

* * *

>take shard
A broken shard of glass. It came from a broken wineglass in the greatroom. The ruined facets of vintage crystal reflected light like a cheap engagement ring.

I crouched down for a closer look and realized it had come from a shattered wineglass,  the pieces obscured by the sofa

FoundClues: 5

>look
Greatroom
The greatroom was clearly where the occupants of the house were meant to spend the majority of their time. Tall, dark wooden rafters criscrossed the high ceiling, the exposed beams clearly meant to evoke a Swiss chalet.

A large set of sofas were arranged around a huge rug. A dark wine stain was conspicuous on the armrest, standing out on the white fabric. Everything in the room faced a gray slate fireplace. A fire roared inside, fresh logs having been added not too long ago.

A small spiral staircase in the corner led up to a reading nook, which was open to the greatroom, separated by a wooden balustrade. Coming from somewhere up there I heard "God Rest Ye Merry, Gentlemen" warbling from what sounded like an old radio.

I could see a glass shard and a broken wineglass here.

FoundClues: 5

>x glass shard
A broken shard of glass. It came from a broken wineglass in the greatroom. The ruined facets of vintage crystal reflected light like a cheap engagement ring.

I crouched down for a closer look and realized it had come from a shattered wineglass,  the pieces obscured by the sofa

FoundClues: 5

>look
Greatroom
The greatroom was clearly where the occupants of the house were meant to spend the majority of their time. Tall, dark wooden rafters criscrossed the high ceiling, the exposed beams clearly meant to evoke a Swiss chalet.

A large set of sofas were arranged around a huge rug. A dark wine stain was conspicuous on the armrest, standing out on the white fabric. Everything in the room faced a gray slate fireplace. A fire roared inside, fresh logs having been added not too long ago.

A small spiral staircase in the corner led up to a reading nook, which was open to the greatroom, separated by a wooden balustrade. Coming from somewhere up there I heard "God Rest Ye Merry, Gentlemen" warbling from what sounded like an old radio.

I could see a glass shard and a broken wineglass here.

FoundClues: 5
I heard the front door open, and the sound of voices from the foyer. It closed a minute later.

Val came down the stairs, and crossed the room toward the sound of the noise.

I beg your pardon?

>e
Downstairs Hallway
FoundClues: 5

>x painting
An oil painting of a crowded scene, bright colors jumping out from shadows and mottled light coming down from above. Everyone in the painting seemed pretty upset, though it wasn't really apparent why. It looked like it was done in the Romantic style, but I'm no art historian. It could just as easily have been the Old Testament as Paradise Lost.

FoundClues: 5

* * *

>x x stain
I couldn't see any such thing.

>x stain
I couldn't see any such thing.

>clues
Clues

* * *

>x knife
It looked like a silver carving knife with an ivory handle. A monogram on the end read "AHB". It didn't look that long or that sharp, but someone had made a pretty clean business of stabbing Bowden with it. Or maybe they'd just gotten lucky. It happens like that sometimes.

FoundClues: 3

>d
Greatroom
The greatroom was clearly where the occupants of the house were meant to spend the majority of their time. Tall, dark wooden rafters criscrossed the high ceiling, the exposed beams clearly meant to evoke a Swiss chalet.

A large set of sofas were arranged around a huge rug. A dark stain was conspicuous on the armrest, standing out on the white fabric. Everything in the room faced a gray slate fireplace. A fire roared inside, fresh logs having been added not too long ago.

A small spiral staircase in the corner led up to a reading nook, which was open to the greatroom, separated by a wooden balustrade. Coming from somewhere up there I heard "We Three Kings" warbling from what sounded like an old radio.

FoundClues: 3

>x stain
An oblong dark red spot about the size of a pear stood out from the beige couch. From the color, it looked like wine. As I looked at it, I realized something on the floor was reflecting firelight back at me.

FoundClues: 4

* * *

>x shard
A broken shard of glass. The ruined facets of vintage crystal reflected light like a cheap engagement ring.

I crouched down for a closer look and realized it had come from a shattered wineglass,  the pieces obscured by the sofa

FoundClues: 4

>look
Greatroom
The greatroom was clearly where the occupants of the house were meant to spend the majority of their time. Tall, dark wooden rafters criscrossed the high ceiling, the exposed beams clearly meant to evoke a Swiss chalet.

A large set of sofas were arranged around a huge rug. A dark wine stain was conspicuous on the armrest, standing out on the white fabric. Everything in the room faced a gray slate fireplace. A fire roared inside, fresh logs having been added not too long ago.

A small spiral staircase in the corner led up to a reading nook, which was open to the greatroom, separated by a wooden balustrade. Coming from somewhere up there I heard "God Rest Ye Merry, Gentlemen" warbling from what sounded like an old radio.

I could see a broken wineglass here.

FoundClues: 4

>x broken
I couldn't see any such thing.

* * *

>x ceiling
I couldn't see any such thing.

* * *

>x knife
It looked like a silver carving knife with an ivory handle. A monogram on the end read "AHB". It didn't look that long or that sharp, but someone had made a pretty clean business of stabbing Bowden with it. Or maybe they'd just gotten lucky. It happens like that sometimes.

FoundClues: 1

>x bottle
A Bordeaux from back in 2001, uncorked and almost empty. Expensive bottle to be drinking alone.

FoundClues: 2

>x wineglass
A crystal wineglass, empty but for a few drops of red wine at the bottom.

FoundClues: 3

>d
Greatroom
The greatroom was clearly where the occupants of the house were meant to spend the majority of their time. Tall, dark wooden rafters criscrossed the high ceiling, the exposed beams clearly meant to evoke a Swiss chalet.

A large set of sofas were arranged around a huge rug. A dark stain was conspicuous on the armrest, standing out on the white fabric. Everything in the room faced a gray slate fireplace. A fire roared inside, fresh logs having been added not too long ago.

A small spiral staircase in the corner led up to a reading nook, which was open to the greatroom, separated by a wooden balustrade. Coming from somewhere up there I heard "Hark, The Herald Angels Sing" warbling from what sounded like an old radio.

FoundClues: 3

>x x stain
I couldn't see any such thing.

>x stain
An oblong dark red spot about the size of a pear stood out from the beige couch. From the color, it looked like wine. As I was looking at it, I realized something on the floor was reflecting firelight back at me.

FoundClues: 4

>clues
Clues

bottle of wine

stain on Greatroom sofa
wineglass

knife

>x shard
A broken shard of glass. The ruined facets of vintage crystal reflected light like a cheap engagement ring.

I crouched down for a closer look and realized it had come from a shattered wineglass,  the pieces obscured by the sofa

FoundClues: 5

>clues
Clues

bottle of wine

stain on Greatroom sofa
wineglass

knife

>x shattered
The curves of the wineglass were jagged edges now, a heap of shattered crystal under the sofa. It must've fallen from quite a height.

FoundClues: 6

>i
I was carrying:
  a cell phone

FoundClues: 6

>x cell phone
I saw nothing special about the cell phone.

FoundClues: 7

* * *

>x wineglass
A crystal wineglass, empty but for a few drops of red wine at the bottom.

FoundClues: 1

>d
Greatroom
The greatroom was clearly where the occupants of the house were meant to spend the majority of their time. Tall, dark wooden rafters criscrossed the high ceiling, the exposed beams clearly meant to evoke a Swiss chalet.

A large set of sofas were arranged around a huge rug. A dark stain was conspicuous on the armrest, standing out on the white fabric. Everything in the room faced a gray slate fireplace. A fire roared inside, fresh logs having been added not too long ago.

A small spiral staircase in the corner led up to a reading nook, which was open to the greatroom, separated by a wooden balustrade. Coming from somewhere up there I heard "O Come, All Ye Faithful" warbling from what sounded like an old radio.

FoundClues: 1

>x x stain
I couldn't see any such thing.

>x stain
An oblong dark red spot about the size of a pear stood out from the beige couch. From the color, it looked like wine. As I looked at it, I realized something on the floor was reflecting firelight back at me.

FoundClues: 2

>clues
Clues

stain on Greatroom sofa
wineglass

>x shard
A broken shard of glass. The ruined facets of vintage crystal reflected light like a cheap engagement ring.

I crouched down for a closer look and realized it had come from a shattered wineglass,  the pieces obscured by the sofa

FoundClues: 2

>clues
Clues

stain on Greatroom sofa
wineglass

>x shattered
The curves of the wineglass were jagged edges now, a heap of shattered crystal under the sofa. It must've fallen from quite a height.

FoundClues: 3

>i
I was carrying:
  a cell phone

FoundClues: 3

>x cell phone
I saw nothing special about the cell phone.

FoundClues: 3

* * *

>n/n/n/n/n/n/n/n/n/n/n
That noun did not make sense in this context.

* * *

>rules all
Rules tracing now switched to "all". Type "rules off" to switch it off again.

[Rule "reset after retrying input rule" does not apply (wrong context).]

* * *

>scope
[Rule "After reading a command when the player's command includes "say/ask/answer/discuss/tell/a/t" and the player's command includes "about" and the player's command does not include "ask/tell/a/t about"" does not apply (wrong context).]
[Rule "flatten ifs rule" applies.]
[Rule "thrashing hopelessly rule" applies.]
[Rule "After reading a command" applies.]
[Rule "After reading a command" applies.]
[Rule "After reading a command" applies.]
[Rule "After reading a command" applies.]
[Rule "declare everything initially unmentioned rule" applies.]
1: radio (786332)
2: Window (786300)
3: Road (786268)
4: myself (786076)
5: a cell phone (786108)
[Rule "quip scope handling rule" does not apply (wrong context).]

[Rule "reset after retrying input rule" does not apply (wrong context).]