Mercedes is a subject.
Ski chalet is a subject.
Dawn is a subject.

Blood on the Snow
An Interactive Fiction by PN
Release 1 / Serial number 150106 / Inform 7 build 6L38 (I6/v6.33 lib 6/12N) SD

Mountain Road
They say you shouldn't drive when you're angry. That was just one of a hundred pieces of good advice I was ignoring as I drove north along the icy road to the chalet, my foot a little heavier on the gas than it needed to be.

I'd had a long, promising career in homicide ahead of me, or so I kept telling myself, and it was all down the drain now. I had planned on a senior detective's desk being in the cards for me, at least. Maybe even quitting and going into private investigations. Well, I guessed I could still do that.

Not six hours earlier, I'd turned in my badge and my gun and walked out, more or less the way I'd seen it in the movies. The captain was yelling his head off, couldn't figure out why a promising young detective like me would just up and quit. I honestly hoped he never did.

>look
Mountain Road
They say you shouldn't drive when you're angry. That was just one of a hundred pieces of good advice I was ignoring as I drove north along the icy road to the chalet, my foot a little heavier on the gas than it needed to be.

I'd had a long, promising career in homicide ahead of me, or so I kept telling myself, and it was all down the drain now. I had planned on a senior detective's desk being in the cards for me, at least. Maybe even quitting and going into private investigations. Well, I guessed I could still do that.

Not six hours earlier, I'd turned in my badge and my gun and walked out, more or less the way I'd seen it in the movies. The captain was yelling his head off, couldn't figure out why a promising young detective like me would just up and quit. I honestly hoped he never did.

>i
I was carrying:
  a cell phone

* * *

>x broken_wineglass
I couldn't see any such thing.

* * *

>look
Mountain Road
They say you shouldn't drive when you're angry. That was just one of a hundred pieces of good advice I was ignoring as I drove north along the icy road to the chalet, my foot a little heavier on the gas than it needed to be.

I'd had a long, promising career in homicide ahead of me, or so I kept telling myself, and it was all down the drain now. I had planned on a senior detective's desk being in the cards for me, at least. Maybe even quitting and going into private investigations. Well, I guessed I could still do that.

Not six hours earlier, I'd turned in my badge and my gun and walked out, more or less the way I'd seen it in the movies. The captain was yelling his head off, couldn't figure out why a promising young detective like me would just up and quit. I honestly hoped he never did.

* * *

>scnes
That noun did not make sense in this context.

>scenes
Scene 'Entire Game' playing (for 24 mins now)
Scene 'Mountain_Driving' ended
Scene 'Car_Escape' ended
Scene 'Cliff_Climbing' ended
Scene 'Car_Embarking' ended
Scene 'Riding_Scene' ended
Scene 'Body_Discovery' ended
Scene 'Prearrival' playing (for 10 mins now)
(Scene monitoring now switched on. Type "scenes off" to switch it off again.)

>e
Downstairs Hallway
[Scene 'Guest_Arrival' begins]
I heard the front door open, and the sound of voices from the foyer. It closed a minute later.

[Scene 'Prearrival' ends]

I beg your pardon?

>w
Greatroom
The greatroom was clearly where the occupants of the house were meant to spend the majority of their time. Tall dark rafters criscrossed the high ceiling, the exposed beams clearly meant to evoke a Swiss chalet.

A large set of sofas were arranged around a huge rug. A dark stain was conspicuous on the armrest, standing out on the white fabric. Everything in the room faced a gray slate fireplace. A fire roared inside, fresh logs having been added not too long ago.

A small spiral staircase in the corner led up to a reading nook, which was open to the greatroom, separated by a wooden balustrade. Coming from somewhere up there I heard "Angels We Have Heard on High" warbling from what sounded like an old radio.

>w
Foyer
I walked into the spacious foyer, trying not to walk into the large lacquered screens in front of the door. The shiny black wood was decorated with an intricate picture in gold paint, depicting a Chinese court scene. It seemed at odds with the exterior of the house, but matched the rest of the decor; the interior was a mixture of Old World furniture and Asian influences. 

Three men stood on the rug, their coats and pant cuffs damp with snow. Val made introductions all around, as if nothing was wrong. 

I studied their faces carefully. If one of them knew about Alan upstairs, they weren't letting on. The three men were overdressed for vacation, as rich men often are. But somehow, they were oddly mismatched. I doubted that they came here together.

 I could tell right away that something was wrong, like the door had been damaged somehow.

I could also see Nathan, Scott and Jan here.

>talk to scott
I couldn't see any such thing.

>talk to jan
I couldn't see any such thing.

>talk to nathan
I couldn't see any such thing.

>look
Foyer
I walked into the spacious foyer, trying not to walk into the large lacquered screens in front of the door. The shiny black wood was decorated with an intricate picture in gold paint, depicting a Chinese court scene. It seemed at odds with the exterior of the house, but matched the rest of the decor; the interior was a mixture of Old World furniture and Asian influences. 

Three men stood on the rug, their coats and pant cuffs damp with snow. Val made introductions all around, as if nothing was wrong. 

I studied their faces carefully. If one of them knew about Alan upstairs, they weren't letting on. The three men were overdressed for vacation, as rich men often are. But somehow, they were oddly mismatched. I doubted that they came here together.

 I could tell right away that something was wrong, like the door had been damaged somehow.

I could also see Nathan, Scott and Jan here.

>scenes
Scene 'Entire Game' playing (for 28 mins now)
Scene 'Mountain_Driving' ended
Scene 'Car_Escape' ended
Scene 'Cliff_Climbing' ended
Scene 'Car_Embarking' ended
Scene 'Riding_Scene' ended
Scene 'Body_Discovery' ended
Scene 'Prearrival' ended
Scene 'Guest_Arrival' playing (for 3 mins now)
(Scene monitoring now switched on. Type "scenes off" to switch it off again.)

>look
Foyer
I walked into the spacious foyer, trying not to walk into the large lacquered screens in front of the door. The shiny black wood was decorated with an intricate picture in gold paint, depicting a Chinese court scene. It seemed at odds with the exterior of the house, but matched the rest of the decor; the interior was a mixture of Old World furniture and Asian influences. 

Three men stood on the rug, their coats and pant cuffs damp with snow. Val made introductions all around, as if nothing was wrong. 

I studied their faces carefully. If one of them knew about Alan upstairs, they weren't letting on. The three men were overdressed for vacation, as rich men often are. But somehow, they were oddly mismatched. I doubted that they came here together.

 I could tell right away that something was wrong, like the door had been damaged somehow.

I could also see Nathan, Scott and Jan here.

>x val
She wore a belted black overcoat with straight shoulders, which covered all of her except for the bottom of a long pencil skirt. She hadn't bothered taking her driving gloves off. I couldn't put my finger on it, but there was something stiffly formal and practised about the way she moved.

>look
Foyer
I walked into the spacious foyer, trying not to walk into the large lacquered screens in front of the door. The shiny black wood was decorated with an intricate picture in gold paint, depicting a Chinese court scene. It seemed at odds with the exterior of the house, but matched the rest of the decor; the interior was a mixture of Old World furniture and Asian influences. 

Three men stood on the rug, their coats and pant cuffs damp with snow. Val made introductions all around, as if nothing was wrong. 

I studied their faces carefully. If one of them knew about Alan upstairs, they weren't letting on. The three men were overdressed for vacation, as rich men often are. But somehow, they were oddly mismatched. I doubted that they came here together.

 I could tell right away that something was wrong, like the door had been damaged somehow.

I could also see Nathan, Scott and Jan here.

>close front door
That was already closed.

* * *

>scenes
Scene 'Entire Game' playing (for 22 mins now)
Scene 'Mountain_Driving' ended
Scene 'Car_Escape' ended
Scene 'Cliff_Climbing' ended
Scene 'Car_Embarking' ended
Scene 'Riding_Scene' ended
Scene 'Body_Discovery' playing (for 14 mins now)
(Scene monitoring now switched on. Type "scenes off" to switch it off again.)

>d
I couldn't go that way.

>u
Reading Nook
I climbed the stairs to the reading nook. Shelves lined the walls of the small room, and a couple of books had been knocked off them onto the floor. A pair of wingback armchairs faced each other with a coffee table in between. A small pool of red liquid lay underneath the table.

A man sat in one, slightly paunchy and slightly grey, his eyes and mouth wide open. His glasses were askew. He was wearing a navy blue cardigan, stained all over the front with a dark, almost black liquid. What looked like a small knife was sticking out of his neck, plunged in so far that only the handle was visible.

An antique wooden radio sat on the table, playing Christmas carols.

I could also see a bottle of wine and a wineglass here.

>d
Greatroom
The greatroom was clearly where the occupants of the house were meant to spend the majority of their time. Tall dark rafters criscrossed the high ceiling, the exposed beams clearly meant to evoke a Swiss chalet.

A large set of sofas were arranged around a huge rug. A dark stain was conspicuous on the armrest, standing out on the white fabric. Everything in the room faced a gray slate fireplace. A fire roared inside, fresh logs having been added not too long ago.

A small spiral staircase in the corner led up to a reading nook, which was open to the greatroom, separated by a wooden balustrade. Coming from somewhere up there I heard "Hark, The Herald Angels Sing" warbling from what sounded like an old radio.

>u
Reading Nook
I climbed the stairs to the reading nook. Shelves lined the walls of the small room, and a couple of books had been knocked off them onto the floor. A pair of wingback armchairs faced each other with a coffee table in between. A small pool of red liquid lay underneath the table.

A man sat in one, slightly paunchy and slightly grey, his eyes and mouth wide open. His glasses were askew. He was wearing a navy blue cardigan, stained all over the front with a dark, almost black liquid. What looked like a small knife was sticking out of his neck, plunged in so far that only the handle was visible.

An antique wooden radio sat on the table, playing Christmas carols.

I could also see a bottle of wine and a wineglass here.

>d
Greatroom
The greatroom was clearly where the occupants of the house were meant to spend the majority of their time. Tall dark rafters criscrossed the high ceiling, the exposed beams clearly meant to evoke a Swiss chalet.

A large set of sofas were arranged around a huge rug. A dark stain was conspicuous on the armrest, standing out on the white fabric. Everything in the room faced a gray slate fireplace. A fire roared inside, fresh logs having been added not too long ago.

A small spiral staircase in the corner led up to a reading nook, which was open to the greatroom, separated by a wooden balustrade. Coming from somewhere up there I heard "God Rest Ye Merry, Gentlemen" warbling from what sounded like an old radio.

>u
Reading Nook
I climbed the stairs to the reading nook. Shelves lined the walls of the small room, and a couple of books had been knocked off them onto the floor. A pair of wingback armchairs faced each other with a coffee table in between. A small pool of red liquid lay underneath the table.

A man sat in one, slightly paunchy and slightly grey, his eyes and mouth wide open. His glasses were askew. He was wearing a navy blue cardigan, stained all over the front with a dark, almost black liquid. What looked like a small knife was sticking out of his neck, plunged in so far that only the handle was visible.

An antique wooden radio sat on the table, playing Christmas carols.

I could also see a bottle of wine and a wineglass here.

>d
Greatroom
The greatroom was clearly where the occupants of the house were meant to spend the majority of their time. Tall dark rafters criscrossed the high ceiling, the exposed beams clearly meant to evoke a Swiss chalet.

A large set of sofas were arranged around a huge rug. A dark stain was conspicuous on the armrest, standing out on the white fabric. Everything in the room faced a gray slate fireplace. A fire roared inside, fresh logs having been added not too long ago.

A small spiral staircase in the corner led up to a reading nook, which was open to the greatroom, separated by a wooden balustrade. Coming from somewhere up there I heard "O Come, All Ye Faithful" warbling from what sounded like an old radio.

>u
Reading Nook
I climbed the stairs to the reading nook. Shelves lined the walls of the small room, and a couple of books had been knocked off them onto the floor. A pair of wingback armchairs faced each other with a coffee table in between. A small pool of red liquid lay underneath the table.

A man sat in one, slightly paunchy and slightly grey, his eyes and mouth wide open. His glasses were askew. He was wearing a navy blue cardigan, stained all over the front with a dark, almost black liquid. What looked like a small knife was sticking out of his neck, plunged in so far that only the handle was visible.

An antique wooden radio sat on the table, playing Christmas carols.

I could also see a bottle of wine and a wineglass here.

>d
Greatroom
The greatroom was clearly where the occupants of the house were meant to spend the majority of their time. Tall dark rafters criscrossed the high ceiling, the exposed beams clearly meant to evoke a Swiss chalet.

A large set of sofas were arranged around a huge rug. A dark stain was conspicuous on the armrest, standing out on the white fabric. Everything in the room faced a gray slate fireplace. A fire roared inside, fresh logs having been added not too long ago.

A small spiral staircase in the corner led up to a reading nook, which was open to the greatroom, separated by a wooden balustrade. Coming from somewhere up there I heard "We Three Kings" warbling from what sounded like an old radio.

>u
Reading Nook
I climbed the stairs to the reading nook. Shelves lined the walls of the small room, and a couple of books had been knocked off them onto the floor. A pair of wingback armchairs faced each other with a coffee table in between. A small pool of red liquid lay underneath the table.

A man sat in one, slightly paunchy and slightly grey, his eyes and mouth wide open. His glasses were askew. He was wearing a navy blue cardigan, stained all over the front with a dark, almost black liquid. What looked like a small knife was sticking out of his neck, plunged in so far that only the handle was visible.

An antique wooden radio sat on the table, playing Christmas carols.

I could also see a bottle of wine and a wineglass here.

>d
Greatroom
The greatroom was clearly where the occupants of the house were meant to spend the majority of their time. Tall dark rafters criscrossed the high ceiling, the exposed beams clearly meant to evoke a Swiss chalet.

A large set of sofas were arranged around a huge rug. A dark stain was conspicuous on the armrest, standing out on the white fabric. Everything in the room faced a gray slate fireplace. A fire roared inside, fresh logs having been added not too long ago.

A small spiral staircase in the corner led up to a reading nook, which was open to the greatroom, separated by a wooden balustrade. Coming from somewhere up there I heard "Angels We Have Heard on High" warbling from what sounded like an old radio.

>u
Reading Nook
I climbed the stairs to the reading nook. Shelves lined the walls of the small room, and a couple of books had been knocked off them onto the floor. A pair of wingback armchairs faced each other with a coffee table in between. A small pool of red liquid lay underneath the table.

A man sat in one, slightly paunchy and slightly grey, his eyes and mouth wide open. His glasses were askew. He was wearing a navy blue cardigan, stained all over the front with a dark, almost black liquid. What looked like a small knife was sticking out of his neck, plunged in so far that only the handle was visible.

An antique wooden radio sat on the table, playing Christmas carols.

I could also see a bottle of wine and a wineglass here.

* * *

>e
Downstairs Hallway

>e
Kitchen
The kitchen was probably the largest I've seen in my life. Wooden cabinets and handsome tile in earth tones went from wall to wall. The quaint country look was somewhat ruined by the collection of modern stainless steel kitchen appliances. They were brand new and it looked like not one of them had been used.

>w
Downstairs Hallway

>w
Greatroom
The greatroom was clearly where the occupants of the house were meant to spend the majority of their time. Tall dark rafters criscrossed the high ceiling, the exposed beams clearly meant to evoke a Swiss chalet.

A large set of sofas were arranged around a huge rug. A dark stain was conspicuous on the armrest, standing out on the white fabric. Everything in the room faced a gray slate fireplace. A fire roared inside, fresh logs having been added not too long ago.

A small spiral staircase in the corner led up to a reading nook, which was open to the greatroom, separated by a wooden balustrade. Coming from somewhere up there I heard "God Rest Ye Merry, Gentlemen" warbling from what sounded like an old radio.

>e
Downstairs Hallway

* * *

>w
Downstairs Hallway

>w
Greatroom
The greatroom was clearly where the occupants of the house were meant to spend the majority of their time. Tall dark rafters criscrossed the high ceiling, the exposed beams clearly meant to evoke a Swiss chalet.

A large set of sofas were arranged around a huge rug. A dark stain was conspicuous on the armrest, standing out on the white fabric. Everything in the room faced a gray slate fireplace. A fire roared inside, fresh logs having been added not too long ago.

A small spiral staircase in the corner led up to a reading nook, which was open to the greatroom, separated by a wooden balustrade. Coming from somewhere up there I heard "We Three Kings" warbling from what sounded like an old radio.

>scenes
Scene 'Entire Game' playing (for 53 mins now)
Scene 'Mountain_Driving' ended
Scene 'Car_Escape' ended
Scene 'Cliff_Climbing' ended
Scene 'Car_Embarking' ended
Scene 'Riding_Scene' ended
Scene 'Body_Discovery' playing (for 45 mins now)
(Scene monitoring now switched on. Type "scenes off" to switch it off again.)

>u
Reading Nook
I climbed the stairs to the reading nook. Shelves lined the walls of the small room, and a couple of books had been knocked off them onto the floor. A pair of wingback armchairs faced each other with a coffee table in between. A small pool of red liquid lay underneath the table.

A man sat in one, slightly paunchy and slightly grey, his eyes and mouth wide open. His glasses were askew. He was wearing a navy blue cardigan, stained all over the front with a dark, almost black liquid. What looked like a small knife was sticking out of his neck, plunged in so far that only the handle was visible.

An antique wooden radio sat on the table, playing Christmas carols.

I could also see a bottle of wine and a wineglass here.

>x body
He looked like he was fifty, but something about his well-preserved look told me that he was probably sixty. It wasn't that he was in good shape-- I doubted he'd seen much real exercise since he was in high school, and maybe not even then. He struck me as a debate team sort of guy.  I could tell he didn't get out much. His fingers were broad, but smooth. His hands had no calluses and no rings, but he wore a Rolex watch. It wasn't fake, and had cost probably three times what my car was worth before I'd driven it off a cliff a few hours ago.

[Scene 'Body_Discovery' ends]
Val came up the stairs, freezing the second she saw the body. Her eyes narrowed, and I could tell her mind was racing, the first time I'd seen anything but placid boredom on her face. Half of me was relieved to know that there was something in this world that could perturb her. The other half was unnerved by it. She looked away and hitched the poker face back on pretty quick.

Val nodded at the poor stiff and said, "Meet Professor Alan Bowden, our host this weekend."
[Scene 'Prearrival' begins]

>d
Greatroom
The greatroom was clearly where the occupants of the house were meant to spend the majority of their time. Tall dark rafters criscrossed the high ceiling, the exposed beams clearly meant to evoke a Swiss chalet.

A large set of sofas were arranged around a huge rug. A dark stain was conspicuous on the armrest, standing out on the white fabric. Everything in the room faced a gray slate fireplace. A fire roared inside, fresh logs having been added not too long ago.

A small spiral staircase in the corner led up to a reading nook, which was open to the greatroom, separated by a wooden balustrade. Coming from somewhere up there I heard "We Three Kings" warbling from what sounded like an old radio.

>e
Downstairs Hallway

* * *

>w
Downstairs Hallway

>e
Kitchen
The kitchen was probably the largest I've seen in my life. Wooden cabinets and handsome tile in earth tones went from wall to wall. The quaint country look was somewhat ruined by the collection of modern stainless steel kitchen appliances. They were brand new and it looked like not one of them had been used.

* * *

>w
Downstairs Hallway

>w
Greatroom
The greatroom was clearly where the occupants of the house were meant to spend the majority of their time. Tall dark rafters criscrossed the high ceiling, the exposed beams clearly meant to evoke a Swiss chalet.

A large set of sofas were arranged around a huge rug. A dark stain was conspicuous on the armrest, standing out on the white fabric. Everything in the room faced a gray slate fireplace. A fire roared inside, fresh logs having been added not too long ago.

A small spiral staircase in the corner led up to a reading nook, which was open to the greatroom, separated by a wooden balustrade. Coming from somewhere up there I heard "Angels We Have Heard on High" warbling from what sounded like an old radio.

>e
Downstairs Hallway

* * *

>e
Kitchen
The kitchen was probably the largest I've seen in my life. Wooden cabinets and handsome tile in earth tones went from wall to wall. The quaint country look was somewhat ruined by the collection of modern stainless steel kitchen appliances. They were brand new and it looked like not one of them had been used.

>w
Downstairs Hallway
[Scene 'Guest_Arrival' begins]
I heard the front door open, and the sound of voices from the foyer. It closed a minute later.

[Scene 'Prearrival' ends]

I beg your pardon?

* * *

>clues
Clues

>x wine
(the bottle of wine)
A Bordeaux from back in 2001, uncorked and almost empty. Expensive bottle to be drinking alone.

>x wineglass
A crystal wineglass, empty but for a few drops of red wine at the bottom.

>clues
Clues

broken wineglass
bottle of wine

stain
pool of wine
wineglass

>x stain
I couldn't see any such thing.

>d
Greatroom
The greatroom was clearly where the occupants of the house were meant to spend the majority of their time. Tall dark rafters criscrossed the high ceiling, the exposed beams clearly meant to evoke a Swiss chalet.

A large set of sofas were arranged around a huge rug. A dark stain was conspicuous on the armrest, standing out on the white fabric. Everything in the room faced a gray slate fireplace. A fire roared inside, fresh logs having been added not too long ago.

A small spiral staircase in the corner led up to a reading nook, which was open to the greatroom, separated by a wooden balustrade. Coming from somewhere up there I heard "We Three Kings" warbling from what sounded like an old radio.

>x stain
An oblong dark red spot about the size of a pear stood out from the beige couch. From the color, it looked like wine. As I was looking at it, I realized something on the floor was reflecting firelight back at me.

>clues
Clues

broken wineglass
bottle of wine

stain
pool of wine
wineglass

* * *

>look
Reading Nook
I climbed the stairs to the reading nook. Shelves lined the walls of the small room, and a couple of books had been knocked off them onto the floor. A pair of wingback armchairs faced each other with a coffee table in between.

A man sat in one, slightly paunchy and slightly grey, his eyes and mouth wide open. His glasses were askew. He was wearing a navy blue cardigan, stained all over the front with a dark, almost black liquid. What looked like a small knife was sticking out of his neck, plunged in so far that only the handle was visible.

An antique wooden radio sat on the table, playing Christmas carols.

I could also see a bottle of wine here.

* * *

>scenes
Scene 'Entire Game' playing (for 24 mins now)
Scene 'Mountain_Driving' ended
Scene 'Car_Escape' ended
Scene 'Cliff_Climbing' ended
Scene 'Car_Embarking' ended
Scene 'Riding_Scene' ended
Scene 'Body_Discovery' playing (for 16 mins now)
(Scene monitoring now switched on. Type "scenes off" to switch it off again.)

* * *

>talk to val
I was already talking to Val.

I could have asked ask about her car, ask about the chalet or ask about sunrise.

>ask about sunrise
"Sun goes up at 7:03 today. Always check the time before you leave for the night," she said.

I looked out the window, trying not to feel like a kid being lectured by his mom.

I could have asked ask about her car or ask about the chalet.

>ask about house
Where are we going?

TODO.

I could have asked ask about her car.

>ask about car
"Nice ride," I said.

"You should have called," Val replied, ignoring my comment.

>topics
I could have asked about her car, about the chalet or about sunrise.

I could have asked about her car, about the chalet or about sunrise.

* * *

>test
>--> The following tests are available:
'test firstconvo'
'test sunrise_lose'
'test discover'
'test body'
'test arrival'
'test valinvest'

* * *

>ask about nathan
"This Nathaniel Wyndham, is he old money?" I asked.

"I guess. He made a sizeable fortune selling boots to the Allies during World War I, a real war profiteer. He used it to buy that ridiculous title, a couple of country estates, and even restored an old manor house. But a little time running with the Circle crowd will tell you that "old money" is a relative term."

I could have asked ask about Alan, ask about the murder or ask what's in it for me.

>ask about nathaniel
That doesn't seem to be a topic of conversation at the moment.

>ask about nathaniel
That doesn't seem to be a topic of conversation at the moment.

>ask what's in it for me
That doesn't seem to be a topic of conversation at the moment.

>ask what
"Seems like a pretty long way to stick my neck out for you. What's in it for me, exactly?".

She looked at me sharply. I could tell it got a lot of use, it was just as practiced as everything else about her. Here was a woman who wasn't afraid to throw her weight around, and made it bad practice to make her do it."I'm your first client, and I know a lot of people, so how about you make this one on the house? You owe me, remember?"

She had me there. I didn't know if this was the kind of thing I could pay back, but I didn't like owing that kind of debt.

I could have asked ask about Alan or ask about the murder.

>ask what was in it for me
That doesn't seem to be a topic of conversation at the moment.

* * *

>ask what
What would I like to discuss: about the murder or what's in it for me?

* * *

>ask what was in it for me
"Seems like a pretty long way to stick my neck out for you. What's in it for me, exactly?".

She looked at me sharply. I could tell it got a lot of use, it was just as practiced as everything else about her. Here was a woman who wasn't afraid to throw her weight around, and made it bad practice to make her do it."I'm your first client, and I know a lot of people, so how about you make this one on the house? You owe me, remember?"

She had me there. I didn't know if this was the kind of thing I could pay back, but I didn't like owing that kind of debt.

I could have asked ask about Alan, ask about the murder or ask about Nathaniel.

>topics
I could have asked about Alan, about the murder, about Nathaniel or what was in it for me.

I could have asked about Alan, about the murder, about Nathaniel or what was in it for me.

>ask what was in it for me
"Seems like a pretty long way to stick my neck out for you. What's in it for me, exactly?".

She looked at me sharply. I could tell it got a lot of use, it was just as practiced as everything else about her. Here was a woman who wasn't afraid to throw her weight around, and made it bad practice to make her do it."I'm your first client, and I know a lot of people, so how about you make this one on the house? You owe me, remember?"

She had me there. I didn't know if this was the kind of thing I could pay back, but I didn't like owing that kind of debt.

I could have asked ask about Alan, ask about the murder or ask about Nathaniel.

* * *

>ask about Nathan
"This Nathan Wyndham, is he old money?" I asked.

"I guess. He made a sizeable fortune selling boots to the Allies during World War I, a real war profiteer. He used it to buy that ridiculous title, a couple of country estates, and even restored an old manor house. But a little time running with the Circle crowd will tell you that "old money" is a relative term."

I could have asked ask about the murder, ask what's in it for me or ask about alan.

>ask about the murder
Val leaned in close until her face was inches from mine, and lowered her voice, even though no one was around. "Listen, kid. Here's how it's going down. We have a few hours before what passes for the law for our kind shows up stomping their flat feet around. They don't much care if the wrong one of us takes the rap, or if no one does. Alan's nobody to the Circle, I doubt they'd care if this case went stone cold. But he used to be a friend of mine, and this is just something I want to do for him.".

I didnt say anything.

I could have asked ask what's in it for me or ask about alan.

>topics
I could have asked about Nathan, about the murder, what's in it for me or about alan.

I could have asked about Nathan, about the murder, what's in it for me or about alan.

>ask abuot
That doesn't seem to be a topic of conversation at the moment.

* * *

>ask about
Val leaned in close until her face was inches from mine, and lowered her voice, even though no one was around. "Listen, kid. Here's how it's going down. We have a few hours before what passes for the law for our kind shows up stomping their flat feet around. They don't much care if the wrong one of us takes the rap, or if no one does. Alan's nobody to the Circle, I doubt they'd care if this case went stone cold. But he used to be a friend of mine, and this is just something I want to do for him.".

I didnt say anything.

I could have asked ask about Alan, ask about Nathaniel or ask what's in it for me.

>ask about murder
Val leaned in close until her face was inches from mine, and lowered her voice, even though no one was around. "Listen, kid. Here's how it's going down. We have a few hours before what passes for the law for our kind shows up stomping their flat feet around. They don't much care if the wrong one of us takes the rap, or if no one does. Alan's nobody to the Circle, I doubt they'd care if this case went stone cold. But he used to be a friend of mine, and this is just something I want to do for him.".

I didnt say anything.

I could have asked ask about Alan, ask about Nathaniel or ask what's in it for me.

>ask about the murder
Val leaned in close until her face was inches from mine, and lowered her voice, even though no one was around. "Listen, kid. Here's how it's going down. We have a few hours before what passes for the law for our kind shows up stomping their flat feet around. They don't much care if the wrong one of us takes the rap, or if no one does. Alan's nobody to the Circle, I doubt they'd care if this case went stone cold. But he used to be a friend of mine, and this is just something I want to do for him.".

I didnt say anything.

I could have asked ask about Alan, ask about Nathaniel or ask what's in it for me.

>ask who nathan is
That doesn't seem to be a topic of conversation at the moment.

>ask who nathan
"This Nathaniel Wyndham, is he old money?" I asked.

"I guess. He made a sizeable fortune selling boots to the Allies during World War I, a real war profiteer. He used it to buy that ridiculous title, a couple of country estates, and even restored an old manor house. But a little time running with the Circle crowd will tell you that "old money" is a relative term."

I could have asked ask about Alan or ask what's in it for me.

>ask about nathan
"This Nathaniel Wyndham, is he old money?" I asked.

"I guess. He made a sizeable fortune selling boots to the Allies during World War I, a real war profiteer. He used it to buy that ridiculous title, a couple of country estates, and even restored an old manor house. But a little time running with the Circle crowd will tell you that "old money" is a relative term."

I could have asked ask about Alan or ask what's in it for me.

>ask about nathaniel
That doesn't seem to be a topic of conversation at the moment.

* * *

>look
Foyer
I walked into the spacious foyer, trying not to walk into the large lacquered screens in front of the door. The shiny black wood was decorated with an intricate picture in gold paint, depicting a Chinese court scene. It seemed at odds with the exterior of the house, but matched the rest of the decor; the interior was a mixture of Old World furniture and Asian influences. 

 I could tell right away that something was wrong, like the door had been damaged somehow.

I could also see Nathan, Scott and Jan here.

* * *

>hint
That noun did not make sense in this context.