>drive
Mountain Pass
I had the radio on tuned to some news station-- truth be told, I already missed the chatter of the dispatch as I was driving. The traffic report had little bearing on my current locale, but the weather gave me some concern: snowstorm coming up off the Great Lakes, apparently. Spending the weekend with a small crowd I barely knew appealed very little to me. Being cooped up with them the entire time due to weather seemed like a recipe for an epidemic of cabin fever.

>drive
Hairpin Turn
If I'd finished that last thought a few seconds earlier, I might've noticed the caution sign for the sharp turn, barely visible through the snow. The car was going too fast, and the guardrail came out of nowhere.

>brake
I hit the brakes, but the car kept straight for the guardrail, slamming through, and going over.

The back end of the car lost traction and swung out wide, trying vainly to follow the front, just like one of those car commercials. Unfortunately, I was not a professional driver, nor was this a closed course, and the right side of the car went over the edge of the cliff, momentum then taking the rest of the car with it. In shock, my brain couldn't manage to tell my body to do more than grip the wheel uselessly as the car tumbled down the steep incline. I lost count of the rolls after three. The roof hit a tree, and I was jerked upward against the seat belt. Snow from the branches fell into a pile onto the passenger window from the impact. I heard a thud, snuffing out the brief glimpse of moonlight.

Upturned Car
I wasn't sure how long I'd been out. Taking stock of my situation, I was surprised to find myself more or less unhurt, save for a dull ache in my left wrist where I'd tried to brace against the door. I took a few deep breaths, and tried to gather myself-- I was still a little mentally a little shocked and unfocused.

The car was presently lying at the bottom of a cliff on its side. Above me, I could see moonlight, dimly mottled by the snow on the passenger side windows. The windshield in front of me showed nothing but evergreen forest, extending into the darkness.

I was still strapped in, the seat belt made sure I stayed put. At least one thing in this car still knew how to do its job right.

I beg your pardon?

* * *

>wait
Driveway
We stood at the end of a long gravel drive, staring up at a large house with a dark red wood exterior. Steps to the east led to a porch that spanned the facade of the place, wrapping around to a deck in the back that presumably had a great view of the lake and the countryside. It was more ski lodge than cabin, and looked like it could comfortably shelter an entire biathlon team if it had to.

Val got out of the car and took her bag out of the trunk.

"Come on, I'll introduce you to Alan," she said, walking up the drive.

Turn Count: 8
FoundClues: 0

>e
Front Porch
Steps led up from the gravel driveway to the porch. Narrow unpainted wood planks extended the length of the house, along with windows that looked into rooms at the front of the house. Through them, I saw blinds, and a glint of something metallic, like a shutter.

The front door stood open.

There was something about the door that looked like a B&E job.

Turn Count: 9
FoundClues: 0

>examine door
A large wooden door, painted white as a preacher's picket fence. It didn't have a window or peephole. Something seemed odd about the lock, like it had been damaged. There was splintered wood on the side of the doorframe where someone had apparently forced the door open.

Turn Count: 10
FoundClues: 0

* * *

>examine stain
An oblong dark red spot about the size of a pear stood out from the beige couch. From the color, it looked like wine. As I looked at it, I realized something on the floor was reflecting firelight back at me.

Turn Count: 14
FoundClues: 2

>look
Greatroom
The greatroom was clearly where the occupants of the house were meant to spend the majority of their time. Tall, dark wooden rafters criscrossed the high ceiling, the exposed beams clearly meant to evoke a Swiss chalet.

A large set of sofas were arranged around a huge rug. A dark wine stain was conspicuous on the armrest, standing out on the white fabric. Everything in the room faced a gray slate fireplace. A fire roared inside, fresh logs having been added not too long ago.

A small spiral staircase in the corner led up to a reading nook, which was open to the greatroom, separated by a wooden balustrade. Coming from somewhere up there I heard "God Rest Ye Merry, Gentlemen" warbling from what sounded like an old radio.

I could see a glass shard here.

Turn Count: 15
FoundClues: 2

>examine shard
A broken shard of glass. The ruined facets of vintage crystal reflected light like a cheap engagement ring.

I crouched down for a closer look and realized it had come from a shattered wineglass,  the pieces obscured by the sofa.

Turn Count: 16
FoundClues: 2

* * *

>examine broken wineglass
The curves of the wineglass were jagged edges now, a heap of shattered crystal under the sofa. It must've fallen from quite a height.

Turn Count: 17
FoundClues: 3

>take all
broken wineglass: I had enough of a mess on my hands without taking this one with me, but kept it anyway. It told an interesting story.

Turn Count: 18
FoundClues: 3

>i
I was carrying:
  a broken wineglass
  a cell phone

Turn Count: 19
FoundClues: 3

>look
Greatroom
The greatroom was clearly where the occupants of the house were meant to spend the majority of their time. Tall, dark wooden rafters criscrossed the high ceiling, the exposed beams clearly meant to evoke a Swiss chalet.

A large set of sofas were arranged around a huge rug. A dark wine stain was conspicuous on the armrest, standing out on the white fabric. Everything in the room faced a gray slate fireplace. A fire roared inside, fresh logs having been added not too long ago.

A small spiral staircase in the corner led up to a reading nook, which was open to the greatroom, separated by a wooden balustrade. Coming from somewhere up there I heard "O Come, All Ye Faithful" warbling from what sounded like an old radio.

I could see a glass shard here.

Turn Count: 20
FoundClues: 3

>take shard
That was fixed in place.

Turn Count: 21
FoundClues: 3

>u
Reading Nook
I climbed the stairs to the reading nook. Shelves lined the walls of the small room, and a couple of books had been knocked off them onto the floor. A pair of wingback armchairs faced each other with a coffee table in between. A small pool of red liquid lay underneath the table.

A man sat in one, slightly paunchy and slightly grey, his eyes and mouth wide open. His glasses were askew. He was wearing a navy blue cardigan, stained all over the front with a dark, almost black liquid. What looked like a small knife was sticking out of his neck, plunged in so far that only the handle was visible.

An antique wooden radio sat on the table, playing Christmas carols.

I could also see a bottle of wine and a wineglass here.

Turn Count: 22
FoundClues: 3

>x wine
(the bottle of wine)
A Bordeaux from back in 2001, uncorked and almost empty. Expensive bottle to be drinking alone.

Turn Count: 23
FoundClues: 4

>x wineglass
(the broken wineglass)
The curves of the wineglass were jagged edges now, a heap of shattered crystal under the sofa. It must've fallen from quite a height.

Turn Count: 24
FoundClues: 4

>examine body
He looked like he was fifty, but something about his well-preserved look told me that he was probably sixty. It wasn't that he was in good shape-- I doubted he'd seen much real exercise since he was in high school, and maybe not even then. He struck me as a debate team sort of guy.  I could tell he didn't get out much. His fingers were broad, but smooth. His hands had no calluses and no rings, but he wore a Rolex watch. It wasn't fake, and had cost probably three times what my car was worth before I'd driven it off a cliff a few hours ago.

Val came up the stairs, freezing the second she saw the body. Her eyes narrowed, and I could tell her mind was racing, the first time I'd seen anything but placid boredom on her face. Half of me was relieved to know that there was something in this world that could perturb her. The other half was unnerved by it. She looked away and hitched the poker face back on pretty quick.

Val nodded at the poor stiff and said, "Meet Professor Alan Bowden, our host this weekend."

Turn Count: 25
FoundClues: 4

>examine knife
It looked like a silver letter opener with an ivory handle. A monogram on the end read "AHB". It didn't look that long or that sharp, but someone had made a pretty clean business of stabbing Bowden with it. Or maybe they'd just gotten lucky. It happens like that sometimes.

Turn Count: 26
FoundClues: 5

>x book
I couldn't see any such thing.

>showme
Reading Nook - room
    Val_HouseTODO - woman
    myself - person
        broken wineglass - clue
        cell phone
    body
    knife - clue
    shelves
    books
    radio - device
    pool of wine - clue
    bottle of wine - clue
    wineglass - clue

>examine pool of wine
A small pool of red wine had fallen on the rug underneath the table, bleeding out onto the wood floor.

Turn Count: 27
FoundClues: 6

>examine bottle of wine
A Bordeaux from back in 2001, uncorked and almost empty. Expensive bottle to be drinking alone.

Turn Count: 28
FoundClues: 6

>look
Reading Nook
I climbed the stairs to the reading nook. Shelves lined the walls of the small room, and a couple of books had been knocked off them onto the floor. A pair of wingback armchairs faced each other with a coffee table in between. A small pool of red liquid lay underneath the table.

A man sat in one, slightly paunchy and slightly grey, his eyes and mouth wide open. His glasses were askew. He was wearing a navy blue cardigan, stained all over the front with a dark, almost black liquid. What looked like a small knife was sticking out of his neck, plunged in so far that only the handle was visible.

Val stood to my left, looking impassively at the body of Alan Bowden.

An antique wooden radio sat on the table, playing Christmas carols.

I could also see a bottle of wine and a wineglass here.

Turn Count: 29
FoundClues: 6

>x glasses
I couldn't see any such thing.

>x sweater
I couldn't see any such thing.

>x cardigan
I couldn't see any such thing.

>scenes
Scene 'Entire Game' playing (for 29 mins now)
Scene 'Mountain_Driving' ended
Scene 'Car_Escape' ended
Scene 'Cliff_Climbing' ended
Scene 'Car_Embarking' ended
Scene 'Riding_Scene' ended
Scene 'Body_Discovery' ended
Scene 'Prearrival' playing (for 5 mins now)
(Scene monitoring now switched on. Type "scenes off" to switch it off again.)

>look
Reading Nook
I climbed the stairs to the reading nook. Shelves lined the walls of the small room, and a couple of books had been knocked off them onto the floor. A pair of wingback armchairs faced each other with a coffee table in between. A small pool of red liquid lay underneath the table.

A man sat in one, slightly paunchy and slightly grey, his eyes and mouth wide open. His glasses were askew. He was wearing a navy blue cardigan, stained all over the front with a dark, almost black liquid. What looked like a small knife was sticking out of his neck, plunged in so far that only the handle was visible.

Val stood to my left, looking impassively at the body of Alan Bowden.

An antique wooden radio sat on the table, playing Christmas carols.

I could also see a bottle of wine and a wineglass here.

Turn Count: 30
FoundClues: 6

>w
I couldn't go that way.

Turn Count: 31
FoundClues: 6

>d
Greatroom
The greatroom was clearly where the occupants of the house were meant to spend the majority of their time. Tall, dark wooden rafters criscrossed the high ceiling, the exposed beams clearly meant to evoke a Swiss chalet.

A large set of sofas were arranged around a huge rug. A dark wine stain was conspicuous on the armrest, standing out on the white fabric. Everything in the room faced a gray slate fireplace. 

A small spiral staircase in the corner led up to a reading nook, which was open to the greatroom, separated by a wooden balustrade. Coming from somewhere up there I heard "Angels We Have Heard on High" warbling from what sounded like an old radio.

I could see a glass shard here.

Turn Count: 32
FoundClues: 6

>u
Reading Nook
I climbed the stairs to the reading nook. Shelves lined the walls of the small room, and a couple of books had been knocked off them onto the floor. A pair of wingback armchairs faced each other with a coffee table in between. A small pool of red liquid lay underneath the table.

A man sat in one, slightly paunchy and slightly grey, his eyes and mouth wide open. His glasses were askew. He was wearing a navy blue cardigan, stained all over the front with a dark, almost black liquid. What looked like a small knife was sticking out of his neck, plunged in so far that only the handle was visible.

Val stood to my left, looking impassively at the body of Alan Bowden.

An antique wooden radio sat on the table, playing Christmas carols.

I could also see a bottle of wine and a wineglass here.

Turn Count: 33
FoundClues: 6

>e
I couldn't go that way.

Turn Count: 34
FoundClues: 6

>e
I couldn't go that way.

Turn Count: 35
FoundClues: 6
[Scene 'Guest_Arrival' begins]
I heard the front door open, and the sound of voices from the foyer. It closed a minute later.

Val and I glanced at each other across the dead man, and she left back down the stairs.

* * *

>east
Greatroom
The greatroom was clearly where the occupants of the house were meant to spend the majority of their time. Tall, dark wooden rafters criscrossed the high ceiling, the exposed beams clearly meant to evoke a Swiss chalet.

A large set of sofas were arranged around a huge rug. A dark stain was conspicuous on the armrest, standing out on the white fabric. Everything in the room faced a gray slate fireplace. A fire roared inside, fresh logs having been added not too long ago.

A small spiral staircase in the corner led up to a reading nook, which was open to the greatroom, separated by a wooden balustrade. Coming from somewhere up there I heard "God Rest Ye Merry, Gentlemen" warbling from what sounded like an old radio.

Turn Count: 13
FoundClues: 1

>examine stain
An oblong dark red spot about the size of a pear stood out from the beige couch. From the color, it looked like wine. As I looked at it, I realized something on the floor was reflecting firelight back at me.

Turn Count: 14
FoundClues: 2

>look
Greatroom
The greatroom was clearly where the occupants of the house were meant to spend the majority of their time. Tall, dark wooden rafters criscrossed the high ceiling, the exposed beams clearly meant to evoke a Swiss chalet.

A large set of sofas were arranged around a huge rug. A dark wine stain was conspicuous on the armrest, standing out on the white fabric. Everything in the room faced a gray slate fireplace. A fire roared inside, fresh logs having been added not too long ago.

A small spiral staircase in the corner led up to a reading nook, which was open to the greatroom, separated by a wooden balustrade. Coming from somewhere up there I heard "Hark, The Herald Angels Sing" warbling from what sounded like an old radio.

I could see a glass shard here.

Turn Count: 15
FoundClues: 2

>examine shard
A broken shard of glass. The ruined facets of vintage crystal reflected light like a cheap engagement ring.

I crouched down for a closer look and realized it had come from a shattered wineglass,  the pieces obscured by the sofa.

Turn Count: 16
FoundClues: 2

* * *

>examine pool
A small pool of red wine had fallen on the rug underneath the table, bleeding out onto the wood floor.

Turn Count: 24
FoundClues: 6

>down
Greatroom
The greatroom was clearly where the occupants of the house were meant to spend the majority of their time. Tall, dark wooden rafters criscrossed the high ceiling, the exposed beams clearly meant to evoke a Swiss chalet.

A large set of sofas were arranged around a huge rug. A dark wine stain was conspicuous on the armrest, standing out on the white fabric. Everything in the room faced a gray slate fireplace. 

A small spiral staircase in the corner led up to a reading nook, which was open to the greatroom, separated by a wooden balustrade. Coming from somewhere up there I heard "We Three Kings" warbling from what sounded like an old radio.

Turn Count: 25
FoundClues: 6

>up
Reading Nook
I climbed the stairs to the reading nook. Shelves lined the walls of the small room, and a couple of books had been knocked off them onto the floor. A pair of wingback armchairs faced each other with a coffee table in between. A small pool of red liquid lay underneath the table.

A man sat in one, slightly paunchy and slightly grey, his eyes and mouth wide open. His glasses were askew. He was wearing a navy blue cardigan, stained all over the front with a dark, almost black liquid. What looked like a small knife was sticking out of his neck, plunged in so far that only the handle was visible.

Val stood to my left, looking impassively at the body of Alan Bowden.

An antique wooden radio sat on the table, playing Christmas carols.

I could also see a bottle of wine and a wineglass here.

Turn Count: 26
FoundClues: 6

* * *

>down
Greatroom
The greatroom was clearly where the occupants of the house were meant to spend the majority of their time. Tall, dark wooden rafters criscrossed the high ceiling, the exposed beams clearly meant to evoke a Swiss chalet.

A large set of sofas were arranged around a huge rug. A dark wine stain was conspicuous on the armrest, standing out on the white fabric. Everything in the room faced a gray slate fireplace. 

A small spiral staircase in the corner led up to a reading nook, which was open to the greatroom, separated by a wooden balustrade. Coming from somewhere up there I heard "Angels We Have Heard on High" warbling from what sounded like an old radio.

Turn Count: 29
FoundClues: 6

I beg your pardon?

>up
Reading Nook
I climbed the stairs to the reading nook. Shelves lined the walls of the small room, and a couple of books had been knocked off them onto the floor. A pair of wingback armchairs faced each other with a coffee table in between. A small pool of red liquid lay underneath the table.

A man sat in one, slightly paunchy and slightly grey, his eyes and mouth wide open. His glasses were askew. He was wearing a navy blue cardigan, stained all over the front with a dark, almost black liquid. What looked like a small knife was sticking out of his neck, plunged in so far that only the handle was visible.

Val stood to my left, looking impassively at the body of Alan Bowden.

An antique wooden radio sat on the table, playing Christmas carols.

I could also see a bottle of wine and a wineglass here.

Turn Count: 30
FoundClues: 6

>dow
That noun did not make sense in this context.

>down
Greatroom
The greatroom was clearly where the occupants of the house were meant to spend the majority of their time. Tall, dark wooden rafters criscrossed the high ceiling, the exposed beams clearly meant to evoke a Swiss chalet.

A large set of sofas were arranged around a huge rug. A dark wine stain was conspicuous on the armrest, standing out on the white fabric. Everything in the room faced a gray slate fireplace. 

A small spiral staircase in the corner led up to a reading nook, which was open to the greatroom, separated by a wooden balustrade. Coming from somewhere up there I heard "O Come, All Ye Faithful" warbling from what sounded like an old radio.

Turn Count: 31
FoundClues: 6

>up
Reading Nook
I climbed the stairs to the reading nook. Shelves lined the walls of the small room, and a couple of books had been knocked off them onto the floor. A pair of wingback armchairs faced each other with a coffee table in between. A small pool of red liquid lay underneath the table.

A man sat in one, slightly paunchy and slightly grey, his eyes and mouth wide open. His glasses were askew. He was wearing a navy blue cardigan, stained all over the front with a dark, almost black liquid. What looked like a small knife was sticking out of his neck, plunged in so far that only the handle was visible.

Val stood to my left, looking impassively at the body of Alan Bowden.

An antique wooden radio sat on the table, playing Christmas carols.

I could also see a bottle of wine and a wineglass here.

Turn Count: 32
FoundClues: 6
I heard the front door open, and the sound of voices from the foyer. It closed a minute later.

Val and I glanced at each other across the dead man, and she left back down the stairs.

* * *

>up
Reading Nook
I climbed the stairs to the reading nook. Shelves lined the walls of the small room, and a couple of books had been knocked off them onto the floor. A pair of wingback armchairs faced each other with a coffee table in between. A small pool of red liquid lay underneath the table.

A man sat in one, slightly paunchy and slightly grey, his eyes and mouth wide open. His glasses were askew. He was wearing a navy blue cardigan, stained all over the front with a dark, almost black liquid. What looked like a small knife was sticking out of his neck, plunged in so far that only the handle was visible.

Val stood to my left, looking impassively at the body of Alan Bowden.

An antique wooden radio sat on the table, playing Christmas carols.

I could also see a bottle of wine and a wineglass here.

Turn Count: 30
FoundClues: 6

>down
Greatroom
The greatroom was clearly where the occupants of the house were meant to spend the majority of their time. Tall, dark wooden rafters criscrossed the high ceiling, the exposed beams clearly meant to evoke a Swiss chalet.

A large set of sofas were arranged around a huge rug. A dark wine stain was conspicuous on the armrest, standing out on the white fabric. Everything in the room faced a gray slate fireplace. 

A small spiral staircase in the corner led up to a reading nook, which was open to the greatroom, separated by a wooden balustrade. Coming from somewhere up there I heard "God Rest Ye Merry, Gentlemen" warbling from what sounded like an old radio.

Turn Count: 31
FoundClues: 6

>up
Reading Nook
I climbed the stairs to the reading nook. Shelves lined the walls of the small room, and a couple of books had been knocked off them onto the floor. A pair of wingback armchairs faced each other with a coffee table in between. A small pool of red liquid lay underneath the table.

A man sat in one, slightly paunchy and slightly grey, his eyes and mouth wide open. His glasses were askew. He was wearing a navy blue cardigan, stained all over the front with a dark, almost black liquid. What looked like a small knife was sticking out of his neck, plunged in so far that only the handle was visible.

Val stood to my left, looking impassively at the body of Alan Bowden.

An antique wooden radio sat on the table, playing Christmas carols.

I could also see a bottle of wine and a wineglass here.

Turn Count: 32
FoundClues: 6
I heard the front door open, and the sound of voices from the foyer. It closed a minute later.

Val and I glanced at each other across the dead man, and she left back down the stairs.

>down
Greatroom
The greatroom was clearly where the occupants of the house were meant to spend the majority of their time. Tall, dark wooden rafters criscrossed the high ceiling, the exposed beams clearly meant to evoke a Swiss chalet.

A large set of sofas were arranged around a huge rug. A dark wine stain was conspicuous on the armrest, standing out on the white fabric. Everything in the room faced a gray slate fireplace. 

A small spiral staircase in the corner led up to a reading nook, which was open to the greatroom, separated by a wooden balustrade. Coming from somewhere up there I heard "Hark, The Herald Angels Sing" warbling from what sounded like an old radio.

Turn Count: 33
FoundClues: 6

>west
Foyer
I walked into the spacious foyer, trying not to walk into the large lacquered wood screens in front of the door. The shiny black surfaces were decorated with an intricate picture in gold paint, depicting a Chinese court scene. It seemed at odds with the exterior of the house, but matched the rest of the decor; the interior was a mixture of Old World furniture and Asian influences. 

Three men stood on the rug, their coats and pant cuffs damp with snow. Val made introductions all around, as if nothing was wrong. 

I studied their faces carefully. If one of them knew about Alan upstairs, they weren't letting on. The three men were overdressed for vacation, as rich men often are. But somehow, they were oddly mismatched. I doubted that they came here together.

I could also see Nathan, Scott and Jan here.

Turn Count: 34
FoundClues: 6

>x nathan
I couldn't see any such thing.

>scope
1: myself (854988)
2: Val_HouseTODO (855852)
3: Nathan (856940)
4: Scott (856908)
5: Jan (856876)
6: a front door (856076)
7: lock_dummyobj (856140)
8: a glass shard (856524)
9: a broken wineglass (856556)
10: a cell phone (855020)

>examine Nathan
I couldn't see any such thing.

>examine Nathan_Arrival
The sideswept brown locks and pencil mustache were meant to look youthful and sporty, like he'd just stopped playing cricket for teatime. The lines on the face and brow made him look more Vincent Price than Errol Flynn, though. I could tell by the way he stood that he didn't have a care in the world, or at least I wasn't one of them. His half-lidded stare gave him an air of casual arrogance, like he was perpetually waiting for the valet to bring his car around.

Turn Count: 35
FoundClues: 6

>scenes
Scene 'Entire Game' playing (for 35 mins now)
Scene 'Mountain_Driving' ended
Scene 'Car_Escape' ended
Scene 'Cliff_Climbing' ended
Scene 'Car_Embarking' ended
Scene 'Riding_Scene' ended
Scene 'Body_Discovery' ended
Scene 'Prearrival' ended
Scene 'Guest_Arrival' playing (for 3 mins now)
(Scene monitoring now switched on. Type "scenes off" to switch it off again.)

>look
Foyer
I walked into the spacious foyer, trying not to walk into the large lacquered wood screens in front of the door. The shiny black surfaces were decorated with an intricate picture in gold paint, depicting a Chinese court scene. It seemed at odds with the exterior of the house, but matched the rest of the decor; the interior was a mixture of Old World furniture and Asian influences. 

Three men stood on the rug, their coats and pant cuffs damp with snow. Val made introductions all around, as if nothing was wrong. 

I studied their faces carefully. If one of them knew about Alan upstairs, they weren't letting on. The three men were overdressed for vacation, as rich men often are. But somehow, they were oddly mismatched. I doubted that they came here together.

I could also see Nathan, Scott and Jan here.

Turn Count: 36
FoundClues: 6

>e
[Scene 'Guest_Arrival' ends]
[Scene 'First_Investigation' begins]
Val waited a minute for the conversations the three were having to die down.
(Press a key)She folded her arms across her chest and took a deep breath quiet enough that only I heard it.

"Gentlemen, we have a problem. Alan's dead. We found him upstairs, stabbed."

A stunned silence followed. When it was clear no one was going to break it, she went on. "I'm going to call it in to the New York Magistrate's and find out who isn't on vacation that they can send over." She lifted a hand, exposing her pale wrist enough to read the face of her watch. "It's going to be at least six hours before they can send someone, and they'll have to make it through what's left of the winter storm. Until we can figure out exactly what happened and who's responsible, I suggest we all stay in our rooms. My associate here has some experience with police investigation, he can do the basics until the officials show up."

Nathaniel seemed to bristle at this. "Hang on a minute, wait in our rooms? Am I to take it you're presuming us suspects? How do I know you and your friend didn't just kill Alan?"

Val shrugged and pointed at me. "It happens that my friend here is the only one of us with a solid alibi, unless I'm mistaken."

The lack of a response indicated that she wasn't, which bothered me a little. The three picked up their bags and trundled down the hall, varying degrees of insulted, Jan called back in a raised voice. "You're making a big mistake. Don't you remember what happened at Lake Geneva in 1986? I think there's someone out there who got Alan, and now we're sitting ducks."

He said it with false bravado, and I shouldn't have let the idea take root in my mind, but it did.

Turn Count: 37
FoundClues: 6

>scenes
Scene 'Entire Game' playing (for 37 mins now)
Scene 'Mountain_Driving' ended
Scene 'Car_Escape' ended
Scene 'Cliff_Climbing' ended
Scene 'Car_Embarking' ended
Scene 'Riding_Scene' ended
Scene 'Body_Discovery' ended
Scene 'Prearrival' ended
Scene 'Guest_Arrival' ended
Scene 'First_Investigation' playing (for 1 mins now)
(Scene monitoring now switched on. Type "scenes off" to switch it off again.)

>look
Foyer
I walked into the spacious foyer, trying not to walk into the large lacquered wood screens in front of the door. The shiny black surfaces were decorated with an intricate picture in gold paint, depicting a Chinese court scene. It seemed at odds with the exterior of the house, but matched the rest of the decor; the interior was a mixture of Old World furniture and Asian influences. 

I could also see Val_HouseTODO here.

Turn Count: 38
FoundClues: 6

>talk to val
I said hello to Val_HouseTODO.

Whisper quiet, shutters slid down on the inside of every window in the house. They looked like opaque fabric window shades, but the heavy sound of the seal told me the core was probably metal. The moonlight went out as suddenly as if someone had thrown a curtain over it.

(press any key)
Turn Count: 39
FoundClues: 6
I could have asked ask about Alan, ask about the murder, ask about Nathaniel or ask what was in it for me.

* * *

I beg your pardon?

>down
Greatroom
The greatroom was clearly where the occupants of the house were meant to spend the majority of their time. Tall, dark wooden rafters criscrossed the high ceiling, the exposed beams clearly meant to evoke a Swiss chalet.

A large set of sofas were arranged around a huge rug. A dark wine stain was conspicuous on the armrest, standing out on the white fabric. Everything in the room faced a gray slate fireplace. 

A small spiral staircase in the corner led up to a reading nook, which was open to the greatroom, separated by a wooden balustrade. Coming from somewhere up there I heard "Angels We Have Heard on High" warbling from what sounded like an old radio.

Turn Count: 33
FoundClues: 6

>west
Foyer
I walked into the spacious foyer, trying not to walk into the large lacquered wood screens in front of the door. The shiny black surfaces were decorated with an intricate picture in gold paint, depicting a Chinese court scene. It seemed at odds with the exterior of the house, but matched the rest of the decor; the interior was a mixture of Old World furniture and Asian influences. 

Three men stood on the rug, their coats and pant cuffs damp with snow. Val made introductions all around, as if nothing was wrong. 

I studied their faces carefully. If one of them knew about Alan upstairs, they weren't letting on. The three men were overdressed for vacation, as rich men often are. But somehow, they were oddly mismatched. I doubted that they came here together.

I could also see Nathan, Scott and Jan here.

Turn Count: 34
FoundClues: 6

* * *

>e
Greatroom
The greatroom was clearly where the occupants of the house were meant to spend the majority of their time. Tall, dark wooden rafters criscrossed the high ceiling, the exposed beams clearly meant to evoke a Swiss chalet.

A large set of sofas were arranged around a huge rug. A dark wine stain was conspicuous on the armrest, standing out on the white fabric. Everything in the room faced a gray slate fireplace. A fire roared inside, fresh logs having been added not too long ago.

A small spiral staircase in the corner led up to a reading nook, which was open to the greatroom, separated by a wooden balustrade. Coming from somewhere up there I heard "Hark, The Herald Angels Sing" warbling from what sounded like an old radio.

Turn Count: 44
FoundClues: 6

>e
Downstairs Hallway
A long narrow corridor connected the entrance of the house with the bedrooms. Lights were recessed into the ceiling overhead, shining down onto the polished wood floor. Maybe some people liked this sterile modern crap, but it made the place look like an art gallery, as far as I was concerned. A couple of paintings even adorned the walls, so maybe that was the idea, and I was just uncultured.

Turn Count: 45
FoundClues: 6

>n
Office
Of all the rooms I'd seen in the house, this one looked the most lived in. It had the musty smell of old books mixed with stale coffee coming from several cups on the desk.

I could see a computer here.

Turn Count: 46
FoundClues: 6

>d
I couldn't go that way.

Turn Count: 47
FoundClues: 6

>s
Downstairs Hallway
A long narrow corridor connected the entrance of the house with the bedrooms. Lights were recessed into the ceiling overhead, shining down onto the polished wood floor. Maybe some people liked this sterile modern crap, but it made the place look like an art gallery, as far as I was concerned. A couple of paintings even adorned the walls, so maybe that was the idea, and I was just uncultured.

Turn Count: 48
FoundClues: 6

>scenes
Scene 'Entire Game' playing (for 48 mins now)
Scene 'Mountain_Driving' ended
Scene 'Car_Escape' ended
Scene 'Cliff_Climbing' ended
Scene 'Car_Embarking' ended
Scene 'Riding_Scene' ended
Scene 'Body_Discovery' ended
Scene 'Prearrival' ended
Scene 'Guest_Arrival' ended
Scene 'First_Investigation' playing (for 11 mins now)
(Scene monitoring now switched on. Type "scenes off" to switch it off again.)

* * *

>eat
What do you want to eat?

>east
I couldn't see any such thing.

>look
Foyer
I walked into the spacious foyer, trying not to walk into the large lacquered wood screens in front of the door. The shiny black surfaces were decorated with an intricate picture in gold paint, depicting a Chinese court scene. It seemed at odds with the exterior of the house, but matched the rest of the decor; the interior was a mixture of Old World furniture and Asian influences. 

I could also see Val_HouseTODO here.

Turn Count: 44
FoundClues: 6

>e
Greatroom
The greatroom was clearly where the occupants of the house were meant to spend the majority of their time. Tall, dark wooden rafters criscrossed the high ceiling, the exposed beams clearly meant to evoke a Swiss chalet.

A large set of sofas were arranged around a huge rug. A dark wine stain was conspicuous on the armrest, standing out on the white fabric. Everything in the room faced a gray slate fireplace. A fire roared inside, fresh logs having been added not too long ago.

A small spiral staircase in the corner led up to a reading nook, which was open to the greatroom, separated by a wooden balustrade. Coming from somewhere up there I heard "O Come, All Ye Faithful" warbling from what sounded like an old radio.

Turn Count: 45
FoundClues: 6

>e
Downstairs Hallway
A long narrow corridor connected the entrance of the house with the bedrooms. Lights were recessed into the ceiling overhead, shining down onto the polished wood floor. Maybe some people liked this sterile modern crap, but it made the place look like an art gallery, as far as I was concerned. A couple of paintings even adorned the walls, so maybe that was the idea, and I was just uncultured.

Turn Count: 46
FoundClues: 6

>n
Office
Of all the rooms I'd seen in the house, this one looked the most lived in. It had the musty smell of old books mixed with stale coffee coming from several cups on the desk.

I could see a computer here.

Turn Count: 47
FoundClues: 6

>x cups
Mugs of coffee, stone cold. I could see brown stains on the sides of the half-empty cups where the liquid had evaporated. They'd been here a few days, but that didn't indicate a time of death. The kind of man who leaves more than two coffee cups sitting on a desk isn't in a hurry to clean up after himself.

Turn Count: 48
FoundClues: 6

>examine books
I couldn't see any such thing.

>examine computer
The computer was switched off.

Turn Count: 49
FoundClues: 6

>switch on computer
I booted up Alan's computer to see what I could find. There were barely any house phones, and I hadn't found his cell phone yet. That meant his e-mail and web browser were probably his main points of contact.
(Type "email" to access e-mail, "history" for search engine autocomplete history)
Turn Count: 50
FoundClues: 6

>history awef
Searching webhistory for awef...

Turn Count: 51
FoundClues: 6

>look
Office
Of all the rooms I'd seen in the house, this one looked the most lived in. It had the musty smell of old books mixed with stale coffee coming from several cups on the desk.

I could see a computer here.

Turn Count: 52
FoundClues: 6

>scenes
Scene 'Entire Game' playing (for 52 mins now)
Scene 'Mountain_Driving' ended
Scene 'Car_Escape' ended
Scene 'Cliff_Climbing' ended
Scene 'Car_Embarking' ended
Scene 'Riding_Scene' ended
Scene 'Body_Discovery' ended
Scene 'Prearrival' ended
Scene 'Guest_Arrival' ended
Scene 'First_Investigation' playing (for 15 mins now)
(Scene monitoring now switched on. Type "scenes off" to switch it off again.)

>scope
1: myself (856268)
2: cups (858508)
3: a desk (858540)
4: a papers (858604)
5: a computer (858636)
6: a glass shard (857804)
7: a broken wineglass (857836)
8: a cell phone (856300)

>showme
Office - room
    myself - person
        glass shard
        broken wineglass - clue
        cell phone
    cups
    desk - closed container
        *bank statement - clue
    papers
    computer - device
* denotes things which are not in scope

>open desk
I opened the desk, revealing a bank statement.

Turn Count: 53
FoundClues: 6

>examine papers
I thumbed through the pile on the desk, finding term papers and dissertations, collections of academic journals. Underneath most of it was something that caught my eye, a document with dollar signs on it and more zeroes than I'm used to seeing on paper.

Turn Count: 54
FoundClues: 6

>x bank statement
I saw nothing special about the bank statement.

Turn Count: 55
FoundClues: 7

>look
Office
Of all the rooms I'd seen in the house, this one looked the most lived in. It had the musty smell of old books mixed with stale coffee coming from several cups on the desk.

I could see a bank statement and a computer here.

Turn Count: 56
FoundClues: 7

>take bank statement
Taken.

Turn Count: 57
FoundClues: 7

>take all
computer: Taken.

Turn Count: 58
FoundClues: 7

>w
I couldn't go that way.

Turn Count: 59
FoundClues: 7

>s
Downstairs Hallway
A long narrow corridor connected the entrance of the house with the bedrooms. Lights were recessed into the ceiling overhead, shining down onto the polished wood floor. Maybe some people liked this sterile modern crap, but it made the place look like an art gallery, as far as I was concerned. A couple of paintings even adorned the walls, so maybe that was the idea, and I was just uncultured.

Turn Count: 60
FoundClues: 7

>up
Upstairs Hallway
Turn Count: 61
FoundClues: 7

>n
North Hallway
Turn Count: 62
FoundClues: 7

>w
(first opening bedroom door)
I reached the room where Val was staying, and supposed it was where I was staying, too. My tired fingers closed tightly around the doorknob like a pitcher throwing his last solid knuckleball in the ninth inning. 

I paused for a moment, mentally tallying what I'd put together about what had happened. I figured I ought to make sure I'd found enough clues for the day before I turned in.

Turn Count: 63
FoundClues: 7

>west
(first opening bedroom door)

Bedroom
I checked my watch, it was getting late, almost noon. I had a million things to think about, but figured I should get a few hours of sleep while I still could.

I could see a bottle of bourbon here.

[Scene 'First_Investigation' ends]
[Scene 'First_Sleep' begins]
Turn Count: 64
FoundClues: 7

>look
Bedroom
I checked my watch, it was getting late, almost noon. I had a million things to think about, but figured I should get a few hours of sleep while I still could.

I could see Val and a bottle of bourbon here.

Turn Count: 65
FoundClues: 7

* * *

>west
(first opening bedroom door)
I reached the room where Val was staying, and supposed it was where I was staying, too. My tired fingers closed tightly around the doorknob like a pitcher throwing his last solid knuckleball in the ninth inning. 

I paused for a moment, mentally tallying what I'd put together about what had happened. I figured I ought to make sure I'd found enough clues for the day before I turned in.

Turn Count: 55
FoundClues: 7

>west
(first opening bedroom door)

Bedroom
I checked my watch, it was getting late, almost noon. I had a million things to think about, but figured I should get a few hours of sleep while I still could.

I could see a bottle of bourbon here.

Turn Count: 56
FoundClues: 7

I beg your pardon?

>look
Bedroom
I checked my watch, it was getting late, almost noon. I had a million things to think about, but figured I should get a few hours of sleep while I still could.

I could see Val and a bottle of bourbon here.

Turn Count: 57
FoundClues: 7

>drin bourbon
That noun did not make sense in this context.

>drink bourbon
I poured out a measure into one of the glasses on the nightstand and drank it slowly, letting it linger on my tongue.

I thought about the idea that someone was just outside the window, peering in, waiting the way a hunter sits in a blind, waiting for ducks. I thought about the three men I'd just met, and how I liked none of them. I thought about the man I'd seen in the chair with his eyes wide open, who didn't seem to mind that I was drinking his bourbon, since he didn't mind much of anything anymore.

Turn Count: 58
FoundClues: 7

>drink
What do you want to drink?

>drink bourbon
I went back to the bottle and poured again, more generous this time. I listened to the sound of something between snow and frozen rain pattering against the window. I listened to Val's steady breathing. She was either asleep, or thinking just as hard as I was. I stared at her back a long time, trying to decide if I wanted to talk to her.

Turn Count: 59
FoundClues: 7

>talk to val
I said hello to Val.

Turn Count: 60
FoundClues: 7
I could have asked ask how long she'd known Bowden.

>ask how long
"How well did you know Alan?"

"I suppose we've spent a lot of time together over the years at little soires like this one. But not well, no."

Turn Count: 61
FoundClues: 7

>look
Bedroom
I checked my watch, it was getting late, almost noon. I had a million things to think about, but figured I should get a few hours of sleep while I still could.

I could see Val and a bottle of bourbon here.

Turn Count: 62
FoundClues: 7

>sleep
I changed into my pajamas and got into bed under the covers. I kept a reasonable distance between the two of us on the bed, though she didn't seem the type to get prudish about that kind of thing. I lay there thinking for a long time, trying to put together everything I'd heard into a picture that made sense. After five minutes that took two hours, I fell asleep, and dreamt of nothing.

(press any key)
I awoke to an empty room, bathed in the silver moonlight. She hadn't made a sound when she'd left. It took a second for me to realize that the shutters had gone back up. Through the window, I could see that lights were starting to come on in the distant houses dotted across the mountainside.

I wasn't sure how long I'd slept, but it must have been about eight o'clock.

Turn Count: 63
FoundClues: 7

>look
Bedroom
I checked my watch, it was getting late, almost noon. I had a million things to think about, but figured I should get a few hours of sleep while I still could.

I could see a memo and a bottle of bourbon here.

Turn Count: 64
FoundClues: 7

>scenes
Scene 'Entire Game' playing (for 64 mins now)
Scene 'Mountain_Driving' ended
Scene 'Car_Escape' ended
Scene 'Cliff_Climbing' ended
Scene 'Car_Embarking' ended
Scene 'Riding_Scene' ended
Scene 'Body_Discovery' ended
Scene 'Prearrival' ended
Scene 'Guest_Arrival' ended
Scene 'First_Investigation' ended
Scene 'First_Sleep' ended
Scene 'Wakeup' playing (for 2 mins now)
(Scene monitoring now switched on. Type "scenes off" to switch it off again.)

>drink bourbon
I wasn't feeling especially drowsy.

Turn Count: 65
FoundClues: 7

>look
Bedroom
I checked my watch, it was getting late, almost noon. I had a million things to think about, but figured I should get a few hours of sleep while I still could.

I could see a memo and a bottle of bourbon here.

Turn Count: 66
FoundClues: 7

>drink bourbon
The bottle beckoned, but I had a rule about not having the same thing for two meals in a row.

Turn Count: 67
FoundClues: 7

>drink bourbon
I decided it was time to cut myself off. I'd never found a clue hidden at the bottom of a whiskey bottle.

Turn Count: 68
FoundClues: 7

>drink bourbon
I decided it was time to cut myself off. I'd never found a clue hidden at the bottom of a whiskey bottle.

Turn Count: 69
FoundClues: 7

>look
Bedroom
I checked my watch, it was getting late, almost noon. I had a million things to think about, but figured I should get a few hours of sleep while I still could.

I could see a memo and a bottle of bourbon here.

Turn Count: 70
FoundClues: 7

>e
North Hallway
I could see Adrian here.

Turn Count: 71
FoundClues: 7

>talk to adrian
I said hello to Adrian.

Turn Count: 72
FoundClues: 7
I could have asked ask about questioning me or ask how he knew my name.

* * *

>east
Front Porch
Steps led up from the gravel driveway to the porch. Narrow unpainted wood planks extended the length of the house, along with windows that looked into rooms at the front of the house. Through them, I saw blinds, and a glint of something metallic, like a shutter.

The front door stood open.

There was something about the door that looked like a B&E job.

Turn Count: 9
FoundClues: 0

>east
Foyer
I walked into the spacious foyer, trying not to walk into the large lacquered wood screens in front of the door. The shiny black surfaces were decorated with an intricate picture in gold paint, depicting a Chinese court scene. It seemed at odds with the exterior of the house, but matched the rest of the decor; the interior was a mixture of Old World furniture and Asian influences.

A layer of snow had blown in through the open doorway, and was slowly melting into a puddle on the enormous Persian rug. 

The front door stood open.

There was something about the door that looked like a B&E job.

I could also see Val_HouseTODO here.

Turn Count: 10
FoundClues: 0

>examine door
A large wooden door, painted white as a preacher's picket fence. It didn't have a window or peephole. Something seemed odd about the lock, like it had been damaged. There was splintered wood on the side of the doorframe where someone had apparently forced the door open.

Turn Count: 11
FoundClues: 0

>examine lock
I needed to be on the other side of the door to see what'd been done to the lock.

Turn Count: 12
FoundClues: 0

>look
Foyer
I walked into the spacious foyer, trying not to walk into the large lacquered wood screens in front of the door. The shiny black surfaces were decorated with an intricate picture in gold paint, depicting a Chinese court scene. It seemed at odds with the exterior of the house, but matched the rest of the decor; the interior was a mixture of Old World furniture and Asian influences.

A layer of snow had blown in through the open doorway, and was slowly melting into a puddle on the enormous Persian rug. 

The front door stood open.

I could also see Val_HouseTODO here.

Turn Count: 13
FoundClues: 0

* * *

>examine lock
I needed to be on the other side of the door to see what'd been done to the lock.

Turn Count: 12
FoundClues: 0

>east
Greatroom
The greatroom was clearly where the occupants of the house were meant to spend the majority of their time. Tall, dark wooden rafters criscrossed the high ceiling, the exposed beams clearly meant to evoke a Swiss chalet.

A large set of sofas were arranged around a huge rug. A dark stain was conspicuous on the armrest, standing out on the white fabric. Everything in the room faced a gray slate fireplace. A fire roared inside, fresh logs having been added not too long ago.

A small spiral staircase in the corner led up to a reading nook, which was open to the greatroom, separated by a wooden balustrade. Coming from somewhere up there I heard "We Three Kings" warbling from what sounded like an old radio.

Turn Count: 13
FoundClues: 0

>east
Downstairs Hallway
A long narrow corridor connected the entrance of the house with the bedrooms. Lights were recessed into the ceiling overhead, shining down onto the polished wood floor. Maybe some people liked this sterile modern crap, but it made the place look like an art gallery, as far as I was concerned. A couple of paintings even adorned the walls, so maybe that was the idea, and I was just uncultured.

Turn Count: 14
FoundClues: 0

>examine stain
I couldn't see any such thing.

>look
Downstairs Hallway
A long narrow corridor connected the entrance of the house with the bedrooms. Lights were recessed into the ceiling overhead, shining down onto the polished wood floor. Maybe some people liked this sterile modern crap, but it made the place look like an art gallery, as far as I was concerned. A couple of paintings even adorned the walls, so maybe that was the idea, and I was just uncultured.

Turn Count: 15
FoundClues: 0

>examine shard
I couldn't see any such thing.

>examine broken wineglass
I couldn't see any such thing.

>take all
(the cell phone)
I already had that.

Turn Count: 16
FoundClues: 0

I beg your pardon?

>look
Downstairs Hallway
A long narrow corridor connected the entrance of the house with the bedrooms. Lights were recessed into the ceiling overhead, shining down onto the polished wood floor. Maybe some people liked this sterile modern crap, but it made the place look like an art gallery, as far as I was concerned. A couple of paintings even adorned the walls, so maybe that was the idea, and I was just uncultured.

Turn Count: 17
FoundClues: 0

* * *

>anykey
The seat belt held me firmly in place in what was now the bottom of the upturned car. I wasn't going to be able to see or do much of anything until I unbuckled myself.

>unbuckle self
I wrestled with the jammed seat belt for a moment, then managed to undo it, falling a few inches down against the driver door once the chest belt was free.

* * *

>anykey
That noun did not make sense in this context.

>west
Sharp Bend
I walked on the snowy road about a hundred feet from the hairpin turn where my car had gone over; I could see the tire tracks and broken guardrail to the east.

The second I turned my head to look down the lane, I saw a pair of headlights approach. A black Mercedes pulled up and came to a stop just in front of me. The passenger door opened, and I saw Val looking out at me.

"Get in," she said.

Turn Count: 2
FoundClues: 0

* * *

>get in
I got into the Mercedes.

Sedan
The inside of the Mercedes was yards of brushed metal and hand-stitched leather. It still smelled new. Having run out of things to talk about, I had nothing to do but wait for us to arrive.

Val drove the car, her eyes looking miles beyond the road, the mountains, and the horizon.

Turn Count: 3
FoundClues: 0

>ask about her car
(addressing Val)
I didn't understand that sentence.

Turn Count: 4
FoundClues: 0
I could have asked ask about her car, ask about the chalet or ask about sunrise.

>ask about the chalet
Where are we going?

TODO.

Turn Count: 5
FoundClues: 0
I could have asked ask about her car or ask about sunrise.

>ask about sunrise
"Sun goes up at 7:03 today. Always check the time before you leave for the night," she said.

I looked out the window, trying not to feel like a kid being lectured by his mom.

Turn Count: 6
FoundClues: 0
I could have asked ask about her car.

>wait
Time passed.

Turn Count: 7
FoundClues: 0
I could have asked ask about her car.

>east
I couldn't go that way.

Turn Count: 8
FoundClues: 0
I could have asked ask about her car.

>east
I couldn't go that way.

Turn Count: 9
FoundClues: 0
I could have asked ask about her car.

>examine door
I couldn't see any such thing.

>examine lock
I couldn't see any such thing.

>east
I couldn't go that way.

Turn Count: 10
FoundClues: 0
I could have asked ask about her car.

>east
I couldn't go that way.

Turn Count: 11
FoundClues: 0
I could have asked ask about her car.

>examine stain
I couldn't see any such thing.

>look
Sedan
The inside of the Mercedes was yards of brushed metal and hand-stitched leather. It still smelled new.

Val drove the car, her eyes looking miles beyond the road, the mountains, and the horizon.

Turn Count: 12
FoundClues: 0
I could have asked ask about her car.

>examine shard
I couldn't see any such thing.

* * *

>examine broken wineglass
I couldn't see any such thing.

>take all
There are none at all available!

I beg your pardon?

>look
Sedan
The inside of the Mercedes was yards of brushed metal and hand-stitched leather. It still smelled new.

Val drove the car, her eyes looking miles beyond the road, the mountains, and the horizon.

Turn Count: 13
FoundClues: 0
I could have asked ask about her car.

* * *

>unbuckle self
I wrestled with the jammed seat belt for a moment, then managed to undo it, falling a few inches down against the driver door once the chest belt was free.

>kick windshield
Bracing my back against the sideways seat, I gave the windshield a couple of sharp kicks. I felt the seal start to give, and then it dislodged entirely from the frame, making an exit. It fell out onto the snow with a muffled crunch, and the bitter wind started to blow into the old car. I grabbed my bag and stepped out into the forest.

>e
I couldn't go that way.

Turn Count: 2
FoundClues: 0

>w
Sharp Bend
I walked on the snowy road about a hundred feet from the hairpin turn where my car had gone over; I could see the tire tracks and broken guardrail to the east.

The second I turned my head to look down the lane, I saw a pair of headlights approach. A black Mercedes pulled up and came to a stop just in front of me. The passenger door opened, and I saw Val looking out at me.

"Get in," she said.

Turn Count: 3
FoundClues: 0

>get in
I got into the Mercedes.

Sedan
The inside of the Mercedes was yards of brushed metal and hand-stitched leather. It still smelled new. Having run out of things to talk about, I had nothing to do but wait for us to arrive.

Val drove the car, her eyes looking miles beyond the road, the mountains, and the horizon.

Turn Count: 4
FoundClues: 0

>talk to val
I said hello to Val.

Turn Count: 5
FoundClues: 0
I could have asked ask about her car, ask about the chalet or ask about sunrise.

>ask about her car
"Nice ride," I said.

"You should have called," Val replied, ignoring my comment.

Turn Count: 6
FoundClues: 0
I could have asked ask about the chalet or ask about sunrise.

>ask about the chalet
Where are we going?

TODO.

Turn Count: 7
FoundClues: 0
I could have asked ask about sunrise.

>ask about sunrise
"Sun goes up at 7:03 today. Always check the time before you leave for the night," she said.

I looked out the window, trying not to feel like a kid being lectured by his mom.

Turn Count: 8
FoundClues: 0

>look
Sedan
The inside of the Mercedes was yards of brushed metal and hand-stitched leather. It still smelled new. Having run out of things to talk about, I had nothing to do but wait for us to arrive.

Val drove the car, her eyes looking miles beyond the road, the mountains, and the horizon.

Turn Count: 9
FoundClues: 0

>wait
Driveway
We stood at the end of a long gravel drive, staring up at a large house with a dark red wood exterior. Steps to the east led to a porch that spanned the facade of the place, wrapping around to a deck in the back that presumably had a great view of the lake and the countryside. It was more ski lodge than cabin, and looked like it could comfortably shelter an entire biathlon team if it had to.

Val got out of the car and took her bag out of the trunk.

"Come on, I'll introduce you to Alan," she said, walking up the drive.

Turn Count: 10
FoundClues: 0

>e
Front Porch
Steps led up from the gravel driveway to the porch. Narrow unpainted wood planks extended the length of the house, along with windows that looked into rooms at the front of the house. Through them, I saw blinds, and a glint of something metallic, like a shutter.

The front door stood open.

There was something about the door that looked like a B&E job.

Turn Count: 11
FoundClues: 0

>w
Driveway
We stood at the end of a long gravel drive, staring up at a large house with a dark red wood exterior. Steps to the east led to a porch that spanned the facade of the place, wrapping around to a deck in the back that presumably had a great view of the lake and the countryside. It was more ski lodge than cabin, and looked like it could comfortably shelter an entire biathlon team if it had to.

Turn Count: 12
FoundClues: 0

>e
Front Porch
Steps led up from the gravel driveway to the porch. Narrow unpainted wood planks extended the length of the house, along with windows that looked into rooms at the front of the house. Through them, I saw blinds, and a glint of something metallic, like a shutter.

The front door stood open.

There was something about the door that looked like a B&E job.

Turn Count: 13
FoundClues: 0

>x door
A large wooden door, painted white as a preacher's picket fence. It didn't have a window or peephole. Something seemed odd about the lock, like it had been damaged. There was splintered wood on the side of the doorframe where someone had apparently forced the door open.

Turn Count: 14
FoundClues: 0

>examine lock
I could see obvious scratch marks at the deadbolt that could've been left by an intruder using a lockpick. Going by the state of the doorframe, the attempt hadn't been successful.

Turn Count: 15
FoundClues: 1

>east
Foyer
I walked into the spacious foyer, trying not to walk into the large lacquered wood screens in front of the door. The shiny black surfaces were decorated with an intricate picture in gold paint, depicting a Chinese court scene. It seemed at odds with the exterior of the house, but matched the rest of the decor; the interior was a mixture of Old World furniture and Asian influences.

A layer of snow had blown in through the open doorway, and was slowly melting into a puddle on the enormous Persian rug. 

The front door stood open.

I could also see Val_HouseTODO here.

Turn Count: 16
FoundClues: 1

>talk to val
I said hello to Val_HouseTODO.

Turn Count: 17
FoundClues: 1

>topics
I could have asked nothing.

I could have asked nothing.

>e
Greatroom
The greatroom was clearly where the occupants of the house were meant to spend the majority of their time. Tall, dark wooden rafters criscrossed the high ceiling, the exposed beams clearly meant to evoke a Swiss chalet.

A large set of sofas were arranged around a huge rug. A dark stain was conspicuous on the armrest, standing out on the white fabric. Everything in the room faced a gray slate fireplace. A fire roared inside, fresh logs having been added not too long ago.

A small spiral staircase in the corner led up to a reading nook, which was open to the greatroom, separated by a wooden balustrade. Coming from somewhere up there I heard "Angels We Have Heard on High" warbling from what sounded like an old radio.

Turn Count: 18
FoundClues: 1

>examine stain
An oblong dark red spot about the size of a pear stood out from the beige couch. From the color, it looked like wine. As I looked at it, I realized something on the floor was reflecting firelight back at me.

Turn Count: 19
FoundClues: 2

>look
Greatroom
The greatroom was clearly where the occupants of the house were meant to spend the majority of their time. Tall, dark wooden rafters criscrossed the high ceiling, the exposed beams clearly meant to evoke a Swiss chalet.

A large set of sofas were arranged around a huge rug. A dark wine stain was conspicuous on the armrest, standing out on the white fabric. Everything in the room faced a gray slate fireplace. A fire roared inside, fresh logs having been added not too long ago.

A small spiral staircase in the corner led up to a reading nook, which was open to the greatroom, separated by a wooden balustrade. Coming from somewhere up there I heard "Hark, The Herald Angels Sing" warbling from what sounded like an old radio.

I could see a glass shard here.

Turn Count: 20
FoundClues: 2

>examine shard
A broken shard of glass. The ruined facets of vintage crystal reflected light like a cheap engagement ring.

I crouched down for a closer look and realized it had come from a shattered wineglass,  the pieces obscured by the sofa.

Turn Count: 21
FoundClues: 2

>look
Greatroom
The greatroom was clearly where the occupants of the house were meant to spend the majority of their time. Tall, dark wooden rafters criscrossed the high ceiling, the exposed beams clearly meant to evoke a Swiss chalet.

A large set of sofas were arranged around a huge rug. A dark wine stain was conspicuous on the armrest, standing out on the white fabric. Everything in the room faced a gray slate fireplace. A fire roared inside, fresh logs having been added not too long ago.

A small spiral staircase in the corner led up to a reading nook, which was open to the greatroom, separated by a wooden balustrade. Coming from somewhere up there I heard "We Three Kings" warbling from what sounded like an old radio.

I could see a broken wineglass and a glass shard here.

Turn Count: 22
FoundClues: 2

>examine broken wineglass
The curves of the wineglass were jagged edges now, a heap of shattered crystal under the sofa. It must've fallen from quite a height.

Turn Count: 23
FoundClues: 3

>take all
broken wineglass: I had enough of a mess on my hands without taking this one with me, but kept it anyway. It told an interesting story.

Turn Count: 24
FoundClues: 3

>look
Greatroom
The greatroom was clearly where the occupants of the house were meant to spend the majority of their time. Tall, dark wooden rafters criscrossed the high ceiling, the exposed beams clearly meant to evoke a Swiss chalet.

A large set of sofas were arranged around a huge rug. A dark wine stain was conspicuous on the armrest, standing out on the white fabric. Everything in the room faced a gray slate fireplace. A fire roared inside, fresh logs having been added not too long ago.

A small spiral staircase in the corner led up to a reading nook, which was open to the greatroom, separated by a wooden balustrade. Coming from somewhere up there I heard "O Come, All Ye Faithful" warbling from what sounded like an old radio.

I could see a glass shard here.

Turn Count: 25
FoundClues: 3

>x fireplace
I couldn't see any such thing.

* * *

>kick windshield
Bracing my back against the sideways seat, I gave the windshield a couple of sharp kicks. I felt the seal start to give, and then it dislodged entirely from the frame, making an exit. It fell out onto the snow with a muffled crunch, and the bitter wind started to blow into the old car. I grabbed my bag and stepped out into the forest.

>west
Sharp Bend
I walked on the snowy road about a hundred feet from the hairpin turn where my car had gone over; I could see the tire tracks and broken guardrail to the east.

The second I turned my head to look down the lane, I saw a pair of headlights approach. A black Mercedes pulled up and came to a stop just in front of me. The passenger door opened, and I saw Val looking out at me.

"Get in," she said.

Turn Count: 2
FoundClues: 0

* * *

>kick windshield
The seat belt held me firmly in place in what was now the bottom of the upturned car. I wasn't going to be able to see or do much of anything until I unbuckled myself.

>e
The seat belt held me firmly in place in what was now the bottom of the upturned car. I wasn't going to be able to see or do much of anything until I unbuckled myself.

>w
The seat belt held me firmly in place in what was now the bottom of the upturned car. I wasn't going to be able to see or do much of anything until I unbuckled myself.

>get in
The seat belt held me firmly in place in what was now the bottom of the upturned car. I wasn't going to be able to see or do much of anything until I unbuckled myself.

* * *

>ask about sunrise
The seat belt held me firmly in place in what was now the bottom of the upturned car. I wasn't going to be able to see or do much of anything until I unbuckled myself.

>look
Upturned Car
I wasn't sure how long I'd been out. Taking stock of my situation, I was surprised to find myself more or less unhurt, save for a dull ache in my left wrist where I'd tried to brace against the door. I took a few deep breaths, and tried to gather myself-- I was still a little mentally a little shocked and unfocused.

The car was presently lying at the bottom of a cliff on its side. Above me, I could see moonlight, dimly mottled by the snow on the passenger side windows. The windshield in front of me showed nothing but evergreen forest, extending into the darkness.

I was still strapped in, the seat belt made sure I stayed put. At least one thing in this car still knew how to do its job right.

Turn Count: 1
FoundClues: 0

>wait
The seat belt held me firmly in place in what was now the bottom of the upturned car. I wasn't going to be able to see or do much of anything until I unbuckled myself.

>e
The seat belt held me firmly in place in what was now the bottom of the upturned car. I wasn't going to be able to see or do much of anything until I unbuckled myself.

* * *

>w
The seat belt held me firmly in place in what was now the bottom of the upturned car. I wasn't going to be able to see or do much of anything until I unbuckled myself.

>e
The seat belt held me firmly in place in what was now the bottom of the upturned car. I wasn't going to be able to see or do much of anything until I unbuckled myself.

>x door
The seat belt held me firmly in place in what was now the bottom of the upturned car. I wasn't going to be able to see or do much of anything until I unbuckled myself.

>examine lock
The seat belt held me firmly in place in what was now the bottom of the upturned car. I wasn't going to be able to see or do much of anything until I unbuckled myself.

* * *

>talk to val
The seat belt held me firmly in place in what was now the bottom of the upturned car. I wasn't going to be able to see or do much of anything until I unbuckled myself.

>topics
The seat belt held me firmly in place in what was now the bottom of the upturned car. I wasn't going to be able to see or do much of anything until I unbuckled myself.

>e
The seat belt held me firmly in place in what was now the bottom of the upturned car. I wasn't going to be able to see or do much of anything until I unbuckled myself.

>examine stain
The seat belt held me firmly in place in what was now the bottom of the upturned car. I wasn't going to be able to see or do much of anything until I unbuckled myself.

>look
Upturned Car
I wasn't sure how long I'd been out. Taking stock of my situation, I was surprised to find myself more or less unhurt, save for a dull ache in my left wrist where I'd tried to brace against the door. I took a few deep breaths, and tried to gather myself-- I was still a little mentally a little shocked and unfocused.

The car was presently lying at the bottom of a cliff on its side. Above me, I could see moonlight, dimly mottled by the snow on the passenger side windows. The windshield in front of me showed nothing but evergreen forest, extending into the darkness.

I was still strapped in, the seat belt made sure I stayed put. At least one thing in this car still knew how to do its job right.

Turn Count: 2
FoundClues: 0

>examine shard
The seat belt held me firmly in place in what was now the bottom of the upturned car. I wasn't going to be able to see or do much of anything until I unbuckled myself.

>look
Upturned Car
I wasn't sure how long I'd been out. Taking stock of my situation, I was surprised to find myself more or less unhurt, save for a dull ache in my left wrist where I'd tried to brace against the door. I took a few deep breaths, and tried to gather myself-- I was still a little mentally a little shocked and unfocused.

The car was presently lying at the bottom of a cliff on its side. Above me, I could see moonlight, dimly mottled by the snow on the passenger side windows. The windshield in front of me showed nothing but evergreen forest, extending into the darkness.

I was still strapped in, the seat belt made sure I stayed put. At least one thing in this car still knew how to do its job right.

Turn Count: 3
FoundClues: 0

>examine broken wineglass
The seat belt held me firmly in place in what was now the bottom of the upturned car. I wasn't going to be able to see or do much of anything until I unbuckled myself.

* * *

>take all
The seat belt held me firmly in place in what was now the bottom of the upturned car. I wasn't going to be able to see or do much of anything until I unbuckled myself.

>look
Upturned Car
I wasn't sure how long I'd been out. Taking stock of my situation, I was surprised to find myself more or less unhurt, save for a dull ache in my left wrist where I'd tried to brace against the door. I took a few deep breaths, and tried to gather myself-- I was still a little mentally a little shocked and unfocused.

The car was presently lying at the bottom of a cliff on its side. Above me, I could see moonlight, dimly mottled by the snow on the passenger side windows. The windshield in front of me showed nothing but evergreen forest, extending into the darkness.

I was still strapped in, the seat belt made sure I stayed put. At least one thing in this car still knew how to do its job right.

Turn Count: 4
FoundClues: 0

>x fireplace
The seat belt held me firmly in place in what was now the bottom of the upturned car. I wasn't going to be able to see or do much of anything until I unbuckled myself.

* * *

>kick windshield
The seat belt held me firmly in place in what was now the bottom of the upturned car. I wasn't going to be able to see or do much of anything until I unbuckled myself.

>unbuckle self
I wrestled with the jammed seat belt for a moment, then managed to undo it, falling a few inches down against the driver door once the chest belt was free.

* * *

>w
Sharp Bend
I walked on the snowy road about a hundred feet from the hairpin turn where my car had gone over; I could see the tire tracks and broken guardrail to the east.

The second I turned my head to look down the lane, I saw a pair of headlights approach. A black Mercedes pulled up and came to a stop just in front of me. The passenger door opened, and I saw Val looking out at me.

"Get in," she said.

Turn Count: 2
FoundClues: 0

>e
Bottom of Cliff
I stood on a ridge densely packed with trees some ways below the highway. My wrecked car sat a few feet away. The ridge extended as far as I could see to the north, going nowhere in particular. To the west I saw the steep incline the car had rolled down, and the path it'd cut through the snow and brush.

Turn Count: 3
FoundClues: 0

>w
Sharp Bend
I walked on the snowy road about a hundred feet from the hairpin turn where my car had gone over; I could see the tire tracks and broken guardrail to the east.

A Mercedes is quietly idling here, V8 purring.

Turn Count: 4
FoundClues: 0

>get in
I got into the Mercedes.

Sedan
The inside of the Mercedes was yards of brushed metal and hand-stitched leather. It still smelled new. Having run out of things to talk about, I had nothing to do but wait for us to arrive.

Val drove the car, her eyes looking miles beyond the road, the mountains, and the horizon.

Turn Count: 5
FoundClues: 0

>talk to val
I said hello to Val.

Turn Count: 6
FoundClues: 0
I could have asked ask about her car, ask about the chalet, ask about sunrise, ask why there were two wineglasses, ask why Alan was stabbed using a letter opener or ask why someone cut my brakes.

* * *

>a
The seat belt held me firmly in place in what was now the bottom of the upturned car. I wasn't going to be able to see or do much of anything until I unbuckled myself.

>unbuckle self
I wrestled with the jammed seat belt for a moment, then managed to undo it, falling a few inches down against the driver door once the chest belt was free.

* * *

>a
What do you want to a?

>west
I wasn't talking to anyone.

>get in
You must supply a noun.

Turn Count: 2
FoundClues: 0

>talk to val
I wasn't talking to anyone right then.

>ask about her car
I wasn't talking to anyone.

>ask about the chalet
There was no one there to talk to.

Turn Count: 3
FoundClues: 0

>ask about sunrise
There was no one there to talk to.

Turn Count: 4
FoundClues: 0

>wait
Time passed.

Turn Count: 5
FoundClues: 0

>east
I couldn't go that way.

Turn Count: 6
FoundClues: 0

>east
I couldn't go that way.

Turn Count: 7
FoundClues: 0

>examine door
I couldn't see any such thing.

* * *

>examine lock
I couldn't see any such thing.

>east
I couldn't go that way.

Turn Count: 8
FoundClues: 0

>east
I couldn't go that way.

Turn Count: 9
FoundClues: 0

>examine stain
I couldn't see any such thing.

>look
Bottom of Cliff
I stood on a ridge densely packed with trees some ways below the highway. My wrecked car sat a few feet away. The ridge extended as far as I could see to the north, going nowhere in particular. To the west I saw the steep incline the car had rolled down, and the path it'd cut through the snow and brush.

I was miles from nowhere, and the cherry on top was that my cell phone was broken. It had stopped snowing for the moment. The night sky was starting to lighten, I figured I had an hour before sunrise.

Fucking swell.

Turn Count: 10
FoundClues: 0

>examine shard
I couldn't see any such thing.

* * *

>examine broken wineglass
I couldn't see any such thing.

>take all
(the cell phone)
I already had that.

Turn Count: 11
FoundClues: 0

I beg your pardon?

>look
Bottom of Cliff
I stood on a ridge densely packed with trees some ways below the highway. My wrecked car sat a few feet away. The ridge extended as far as I could see to the north, going nowhere in particular. To the west I saw the steep incline the car had rolled down, and the path it'd cut through the snow and brush.

I was miles from nowhere, and the cherry on top was that my cell phone was broken. It had stopped snowing for the moment. The night sky was starting to lighten, I figured I had an hour before sunrise.

Fucking swell.

Turn Count: 12
FoundClues: 0